Lisbon=Lisabon
Paris=Paříž
León=Leon
Ávila‎=Ávila
San Sebastian=San Sebastián
Vielha=Vielha e Mijaran
Valencia=Valencie
Seville=Sevilla
Jerez=Jerez de la Frontera
Mahón=Maó-Mahón
Evora=Évora
Lamezia=Lamezia Terme
Naples=Neapol
Rome=Řím
Florence=Florencie
Genoa=Janov
Catania=Katánie
Venice=Benátky
Padua=Padova
Trieste=Terst
Turin=Turín
Bra=Podprsenka
Milan=Milán
Mantua=Mantova
Auronzo=Auronzo di Cadore
Londonderry Derry=Londonderry
Portlaoise=Port Laoise
London=Londýn
St Helier=Saint Helier
Monaco=Monako
Geneva=Ženeva
Chamonix=Chamonix-Mont-Blanc
Dunkirk=Dunkerk
Le Touquet=Le Touquet-Paris-Plage
Reims=Remeš
Strasbourg=Štrasburk
Metz=Mety
Mulhouse=Mylhúzy
Lourdes=Lurdy
Brussels=Bruselský region
Liège=Lutych
Ghent=Gent
Antwerp=Antverpy
Bruges=Bruggy
Luxembourg=Lucembursko
Zürich=Curych
Basel=Basilej
Lucerne=Lucern
St Gallen=St. Gallen
Konstanz=Kostnice
Soelden=Sölden
Graz=Štýrský Hradec
Vienna=Vídeň
Linz=Linec
St Pölten=Sankt Pölten
Salzburg=Salcburk
Mistelbach=Mistelbach an der Zaya
Wiener Neustadt=Vídeňské Nové Město
Ljubljana=Lublaň
Novo Mesto=Novo mesto
Budapest=Budapešť
Debrecen=Debrecín
Szeged=Segedín
Sopron=Šoproň
Trinec=Třinec
Hradec Kralove=Hradec Králové
Prague=Praha
Mlada Boleslav=Mladá Boleslav
Ceske Budejovice=České Budějovice
Pisek=Písek
Gdańsk=Gdaňsk
Gdynia=Gdyně
Olsztyn=Olštýn
Augustów=Augustov
Białystok=Bělostok
Łomża=Lomže
Warsaw=Varšava
Ostrołęka=Ostrolenka
Ciechanow=Ciechanów
Łódź=Lodž
Kalisz=Kališ
Częstochowa=Čenstochová
Katowice=Katovice
Bielsko Biala=Bílsko-Bělá
Kraków=Krakov
Zakopane=Zakopané
Rzeszów=Řešov
Opole=Opolí
Wrocław=Vratislav
Wałbrzych=Valbřich
Jelenia Góra=Jelení Hora
Legnica=Lehnice
Kłodzko=Kladsko
Raciborz=Ratiboř
Oleśnica=Olešnice
Zielona Góra=Zelená Hora
Leszno=Lešno
Glogow=Hlohov
Poznań=Poznaň
Gniezno=Hnězdno
Szczecin=Štětín
Świnoujście=Svinoústí
Bydgoszcz=Bydhošť
Toruń=Toruň
Bialogard=Białogard
Sovetsk=Sovětsk
Chernyakhovsk=Čerňachovsk
Bremen=Brémy
Hamburg=Hamburk
Berlin=Berlín
Frankfurt an der Oder=Frankfurt nad Odrou
Cottbus=Chotěbuz
Potsdam=Postupim
Hanover=Hannover
Cologne=Kolín nad Rýnem
Leipzig=Lipsko
Dresden=Drážďany
Chemnitz=Saská Kamenice
Frankfurt=Frankfurt nad Mohanem
Wittenberg=Lutherstadt Wittenberg
Bautzen=Budyšín
Zwickau=Cvikov
Bamberg=Bamberk
Nuremberg=Norimberk
Aachen=Cáchy
Trier=Trevír
Mainz=Mohuč
Giessen=Gießen
Speyer=Špýr
Munich=Mnichov
Regensburg=Řezno
Mühldorf=Mühldorf am Inn
Passau=Pasov
Rain=Déšť
Copenhagen=Kodaň
Gothenburg=Göteborg
Aluksne=Alūksne
Jekabpils=Jēkabpils
Ogre=Zlobr
Chişinău=Kišiněv
Rîbniţa=Rybnica
Iași=Jasy
Bucharest=Bukurešť
Fetești Gară=Fetești
Ploiești=Ploješť
Caracal=Karakal
Timișoara=Temešvár
Reșița=Rešice
Orșova=Oršava
Cluj Napoca=Kluž
Suceava=Sučava
Brașov=Brašov
Sofia=Sofie
Haskovo=Chaskovo
Dobrich=Dobrič
Shumen=Šumen
Yambol=Jambol
Kardzali=Kardžali
Vratsa=Vraca
Koprivshtitsa=Koprivštica
Ohrid=Ochrid
Sarandë=Saranda
Vlorë=Vlora
Durrës=Drač
Lezhë District=Okres Lezhë
Niksic=Nikšić
Peja=Peć
Pristina=Priština
Ferizaj=Uroševac
Belgrade=Bělehrad
Zagreb=Záhřeb
Varaždin=Varaždín
Dubrovnik=Dubrovník
Mali Losinj=Mali Lošinj
Thessaloniki=Soluň
Alexandroupoli=Alexandrupoli
Ioannina=Ioánnina
Larissa=Larisa
Kalabaka=Kalambaka
Igoumenitsa=Igumenica
Corfu=Korfu
Athens=Athény
Chalcis=Chalkis
Corinth=Korint
Delphi=Delfy
Karpenissi=Karpenisi
Heraklion=Heráklion
Nafplion=Nauplion
Patras=Patra
Sparti=Sparta
Zakinthos=Zakynthos
İstanbul=Istanbul
Eskişehir=Eskišehir
Bilecik=Biledžik
İzmir=Smyrna
Mesta=Concejo de la Mesta
Dinar=Dinár
Van=Dodávkový automobil
Elâzığ=Elazığ
Barysaw=Barysaŭ
Baranavichy=Baranavičy
Maladzyechna=Maladzečna
Smarhoń=Smarhoň
Gomel=Homel
Babruysk=Babrujsk
Chachersk=Čačersk
Svietlahorsk=Světlahorsk
Lelchytsy=Lelčycy
Luninets=Luniněc
Fanipaĺ=Fanipal
Orsha=Orša
Byerazino=Berazino
Krychaw=Kryčaŭ
Slawharad=Slaŭharad
Bialyničy=Bjalyničy
Viciebsk=Vitebsk
Lepiel=Lepel
Syanno=Sjanno
Polatsk=Polock
Braslaw=Braslaŭ
Vileyka=Vilejka
