Lisbon=Lisbonne
Zaragoza=Saragosse
A Coruña=La Corogne
Ourense=Orense
Salamanca=Salamanque
Segovia=Ségovie
Pamplona=Pampelune
San Sebastian=Saint-Sébastien
Lleida=Lérida
Barcelona=Barcelone
Tarragona=Tarragone
Girona=Gérone
Figueres=Figueras
Andorra=Andorre
Vielha=Vielha e Mijaran
Valencia=Valence
Cádiz=Cadix
Seville=Séville
Jerez=Jerez de la Frontera
Málaga=Malaga
Granada=Grenade
Murcia=Murcie
Cartagena=Carthagène
Alcoi=Alcoy
Mahón=Port Mahon
Evora=Évora
Palermo=Palerme
Ragusa=Raguse
Agrigento=Agrigente
Messina=Messine
Lamezia=Lamezia Terme
Salerno=Salerne
Taranto=Tarente
Benevento=Bénévent
Gaeta=Gaète
L'Aquila=L'Aquila
Viterbo=Viterbe
Ancona=Ancône
Ravenna=Ravenne
San Marino=Saint-Marin
Perugia=Pérouse
Siena=Sienne
Pisa=Pise
Bologna=Bologne
Genoa=Gênes
Lucca=Lucques
Modena=Modène
Parma=Parme
Ferrara=Ferrare
Catania=Catane
Padua=Padoue
Verona=Vérone
Savona=Savone
Cuneo=Coni
Bra=Soutien-gorge
Sestriere=Sestrières
Aosta=Aoste
Ivrea=Ivrée
Pavia=Pavie
Piacenza=Plaisance
Cremona=Crémone
Vercelli=Verceil
Como=Côme
Alessandria=Alexandrie
Mantua=Mantoue
Bergamo=Bergame
Trento=Trente
Vicenza=Vicence
Valletta=La Valette
London=Londres
Edinburgh=Édimbourg
Geneva=Genève
Dunkirk=Dunkerque
Saintes=Saint
Ghent=Gand
Antwerp=Anvers
Kortrijk=Courtrai
Groningen=Groningue
Breda=Bréda
Tilburg=Tilbourg
Zürich=Zurich
Basel=Bâle
Bern=Berne
St Gallen=Saint-Gall
Konstanz=Constance
Chur=Coire
Soelden=Sölden
Bregenz=Brégence
Vienna=Vienne
Salzburg=Salzbourg
Novo Mesto=Novo mesto
Trinec=Třinec
Pisek=Písek
Znojmo=Znaïm
Warsaw=Varsovie
Ciechanow=Ciechanów
Kraków=Cracovie
Raciborz=Racibórz
Glogow=Głogów
Bialogard=Białogard
Gusev=Goussev
Chernyakhovsk=Tcherniakhovsk
Bremen=Brême
Lüneburg=Lunebourg
Flensburg=Flensbourg
Hamburg=Hambourg
Neubrandenburg=Neubrandenbourg
Magdeburg=Magdebourg
Oranienburg=Oranienbourg
Braunschweig=Brunswick
Hanover=Hanovre
Kassel=Cassel
Jena=Iéna
Dresden=Dresde
Frankfurt=Francfort
Wittenberg=Wittemberg
Würzburg=Wurtzbourg
Coburg=Cobourg
Kleve=Clèves
Aachen=Aix-la-Chapelle
Trier=Trèves
Koblenz=Coblence
Mainz=Mayence
Arolsen=Bad Arolsen
Marburg=Marbourg
Giessen=Gießen
Saarbrücken=Sarrebruck
Speyer=Spire
Augsburg=Augsbourg
Regensburg=Ratisbonne
Mühldorf=Mühldorf am Inn
Günzburg=Guntzbourg
Rain=Pluie
Ravensburg=Ravensbourg
Offenburg=Offenbourg
Copenhagen=Copenhague
Gothenburg=Göteborg
Meraker=Meråker
Verdalsora=Verdalsøra
Reykjavík=Reykjavik
Aluksne=Alūksne
Silene=Silène
Jekabpils=Jēkabpils
Edineţ=Edineț
Chişinău=Chișinău
Rîbniţa=Rîbnița
Cimişlia=Cimișlia
Bucharest=Bucarest
Burgas=Bourgas
Dobrich=Dobritch
Shumen=Choumen
Kardzali=Kardjali
Koprivshtitsa=Koprivchtitsa
Sarandë=Saranda
Korçë=Koritza
Vlorë=Vlora
Niksic=Nikšić
Peja=Peć
Ferizaj=Uroševac
Mali Losinj=Mali Lošinj
Thessaloniki=Thessalonique
Serres=Serrès
Kavala=Kavála
Alexandroupoli=Alexandroúpoli
Xanthi=Xánthi
Nikiti=Nikíti
Kastoria=Kastoriá
Kozani=Kozáni
Veria=Véria
Katerini=Kateríni
Ioannina=Ioánnina
Trikala=Tríkala
Konitsa=Kónitsa
Kalabaka=Kalambáka
Igoumenitsa=Igoumenítsa
Corfu=Corfou
Athens=Athènes
Istiaia=Istiaía
Karystos=Carystos
Corinth=Corinthe
Delphi=Delphes
Atalanti=Atalánti
Volos=Vólos
Karpenissi=Karpenísi
Amfilochia=Amphilochie
Heraklion=Héraklion
Chania=La Canée
Nafplion=Nauplie
Agrinio=Agrínio
Neapoli Voion=Néapoli
Sparti=Sparte
Areopoli=Areópoli
Zakinthos=Zante
İstanbul=Istanbul
Saray=Sérail
İzmir=Izmir
Eresos=Eresós
Side=Sidé
Mut=Mout
Ordu=Altınordu
İskenderun=Alexandrette
Hakkâri=Hakkari
Van=Camionnette
Doğubeyazıt=Doğubayazıt
Barysaw=Baryssaw
Baranavichy=Baranavitchy
Grodno=Hrodna
Maladzyechna=Maladetchna
Smarhoń=Smarhon
Vaŭkavysk=Vawkavysk
Gomel=Homiel
Rečyca=Retchytsa
Babruysk=Babrouïsk
Žlobin=Jlobine
Chachersk=Tchatchersk
Hlusk=Hlousk
Žytkavičy=Jytkavitchy
Lelchytsy=Leltchytsy
Luninets=Louninets
Fanipaĺ=Fanipal
Mogilev=Mahiliow
Orsha=Orcha
Byerazino=Berazino
Krychaw=Krytchaw
Chocimsk=Khotsimsk
Bialyničy=Bialynitchy
Viciebsk=Vitebsk
Syanno=Sianno
Polatsk=Polotsk
Rasony=Rassony
Vileyka=Vileïka
Venice=Venise
Treviso=Trévise
Zug=Zoug
Al Hoceima=Al Hoceïma
Tetouan=Tétouan
Tangier=Tanger
Kenitra=Kénitra
Fes=Fès
Meknes=Meknès
Ain Beida=Aïn Beïda
Tantan=Tan-Tan
Tafraoute=Tafraout
Mhamid=M'Hamid El Ghizlane
Boudenib=Boudnib
Ifran=Ifrane
Khenifra=Khénifra
Khemisset=Khémisset
Marrakesh=Marrakech
El Kef=Le Kef
Graiba=Graïba
Maktar=Makthar
Gabes=Gabès
Awsard=Aousserd
Zug=Zoug
Agounit=Aghouinite
Bir Lehlou=Bir Lahlou
Laayoune=Laâyoune
Guelta Zemmur=Gueltat Zemmour
Bu Craa=Boukraa
Ain Ben Tili=Aïn Ben Tili
Bir Moghrein=Bir Moghreïn
Fderik=F'Derick
Sélibaby=Sélibabi
Tidjikja=Tidjikdja
Tichit=Tichitt
Timbédra=Timbedra
Walatah=Oualata
Ayoun el Atrous=Aïoun El Atrouss
Velingara=Vélingara
Kedougou=Kédougou
St Louis=Saint-Louis
Nova Lamego=Gabu
Forecariah=Forécariah
Tougue=Tougué
Nzerekore=Nzérékoré
Gueckedou=Guéckédou
Kerouane=Kérouané
Soubre=Soubré
Duekoue=Duékoué
Adzope=Adzopé
Bouake=Bouaké
Tiebissou=Tiébissou
Tingrela=Tengréla
Odienne=Odienné
Seguela=Séguéla
Mango=Mangue
Sokode=Sokodé
Kpalime=Kpalimé
Atakpame=Atakpamé
Tamale=Tamal
Wa=WA
Takoradi=Sékondi
Glazoue=Glazoué
Bante=Bantè
Kouande=Kouandé
Brass=Laiton
Ore=Minerai
Nasarawa=Nassarawa
Biu=BIU
Babana=Băbana
Gembu=Tortue noire
Buea=Buéa
Mamfe=Mamfé
Ngaoundere=Ngaoundéré
Mekambo=Mékambo
Ndjole=Ndjolé
Ndende=Ndendé
Sette Cama=Setté Cama
Kelle=Kéllé
Sembe=Sembé
Epena=Epéna
Cape Town=Le Cap
Gqeberha=Port Elizabeth
Bethlehem=Bethléem
Hanover=Hanovre
Johannesburg=Johannesbourg
Musina=Messina
Mokopane=Potgietersrus
Nqanqarhu=Maclear
Kanye=Kanye West
Tshabong=Tsabong
Plumtree=Prune
Gutu=District de Gutu
Mapai=Mapaï
Vilankulos=Vilankulo
Massinga=(760) Massinga
Chepica=Chépica
Quelimane=Quélimane
Mague=Maigue
Estima=Toyota Estima
Mutala=Ylöjärvi
Gurue=Gurué
Ondangwa=Ondangua
Grunau=Grünau
Bethanien=Bethanie
Pomona=Pomone
Luderitz=Lüderitz
Lira=Lire
Kismayo=Kismaayo
Ras Kamboni=Kamboni
Mogadishu=Mogadiscio
Merca=Merka
Baraawe=Brava
Bardere=Bardera
Xuddur=Hudur
Galkayo=Gaal Kacyo
Ceerigaabo=Erigavo
Buhodle=Buuhoodle
Laascaanood=Las Anod
Burco=Burao
Djibouti‎=Djibouti
Akordat=Agordat
Denan=Simvastatine
Degeh Bur=Degehabur
Imi=Imi d'Akkad
Karat=Titre
Jijiga=Djidjiga
Aysha=Aïcha
Adwa=Adoua
Zambezi=Zambèze
Namibe=Moçâmedes
N'dalatando=Ndalantando
Uige=Uíge
N'zeto=N'Zeto
Mutumbo=Dikembe Mutombo
Mbuji Mayi=Mbujimayi
Gandajika=Ngandajika
Kaniama=Kanyama
Makanza=Mankanza
Panga=Pterogymnus laniarius
Kole=Kole Weathers
Masha=Macha
Addis Ababa=Addis-Abeba
Debre Birhan=Debre Berhan
Asayita=Assayta
Bahir Dar=Baher Dar
Dangla=Monts Tanggula
Debre Markos=Debre Marqos
Metema=Métemma
Juba=Djouba
Raga=Râga
Kosho=Kōshō
Dekoa=Dékoa
Zemio=Zémio
N'Délé=Ndélé
Dedougou=Dédougou
Zabre=Zabré
Ouelessebougou=Ouélessébougou
San=SAN
Bla=BLA
Djenne=Djenné
Sandare=Sandaré
Taoudenni=Taoudeni
Timbuktu=Tombouctou
Aguelhok=Aguel'hoc
Anefis=Anéfis
Birnin Konni=Birni N'Konni
Assamakka=Assamaka
Ingal=Ingall
Djado Plateau=Plateau du Djado
N'Djamena=N'Djaména
Ati=ATI
Abeche=Abéché
Guereda=Guéréda
Aouzou=Bande d'Aozou
Al Fashir=El Fasher
El Daein=Ed Dueim
Abyei=Abiyé
Kadugli=Kadougli
Sennar=Sannar
Ad Douiem=Ed Dueim
Port Sudan=Port-Soudan
Abri=Abri sous roche
Omdurman=Omdourman
Shendi=Chendi
Barah=Bara
Halayeb=Hala'ib
Abu Simbel=Temples d'Abou Simbel
Aswan=Assouan
Edfu=Edfou
Safaga=Port Safaga
Naqadah=Nagada
Asyut=Assiout
Faiyum=Médinet el-Fayoum
Nebk=Paliurus spina-christi
Arish=El-Arich
Port Said=Port-Saïd
Mansoura=Mansourah
Damietta=Damiette
Cairo=Le Caire
Banha=Benha
Alexandria=Alexandrie
Rasheed=Rachid
Damanhour=Damanhur
Ismailia=Ismaïlia
Sallum=Sollum
Siwa Oasis=Siwa
Farafra=Al-Farafra
Mut=Mout
Kharga=Al-Kharga
Zuwara=Zouara
Garyan=Gharyan
Sirte=Syrte
Sawknah=Socna
Al Fuqaha=Fuqaha
Zaltan=Zenten
Al Bayda=Bayda
Tobruk=Tobrouk
Al Jaghbub=Al-Jaghboub
Tmassah=Tmessa
Murzuq=Mourzouq
Zawilah=Zawila
Qatrun=Al Qatrun
Nalut=Nalout
Awbari=Oubari
Tebessa=Tébessa
Setif=Sétif
Bou Saada=Bou Saâda
Algiers=Alger
Mecheria=Mécheria
Aïn Séfra=Aïn Sefra
Ghardaia=Ghardaïa
Aïn Oussera=Aïn Oussara
In Ekker=In Ecker
Sile=Şile
Mide=Royaume de Mide
Taolagnaro=Tôlanaro
Saka=Sakas
Belo Tsiribihina=Belon'i Tsiribihina
Taizz=Ta'izz
Dhamar=Dhamâr
Ad Dali=Ad Dali'
Sana'a=Sanaa
Al Bayda=Bayda
Al Hudaydah=Al-Hodeïda
Sa'dah=Sa'dah
Shabwah=Gouvernorat de Chabwa
Balhaf=Bal'haf
Al Mukalla=Al Moukalla
Ash Shihr=Shihr
Seiyun=Say'un
Shisan=Renku
Sadah=Sa'dah
Al Hadd=Al Hidd
Muscat=Mascate
Al Ain=Al-Aïn
Dubai=Dubaï
Fujairah=Fujaïrah
Ras Al-Khaimah=Ras el Khaïmah
Abu Dhabi=Abou Dabi
Al Hamra=Hamra
Be'er Sheva=Beer-Sheva
Haifa=Haïfa
Al Mafraq=Mafraq
Ma'an=Ma'an
Shobak=Krak de Montréal
Kerak=Al-Karak
Nablus=Naplouse
Damascus=Damas
Hebron=Hébron
Jerusalem=Jérusalem
Baqaa=Baqa’
Hail=Grêle
Jubbah=Dishdasha
Unayzah=Unaizah
Medina=Médine
AlUla=Al-'Ula
Kilwa=Kilwa Kisiwani
Khafji=Ras al-Khafji
Al Jubail=Al-Jubayl
Al Hofuf=Al-Hufuf
Riyadh=Riyad
Al Kharj=Al Khardj
Al Majma'ah=Al-Majma'ah
Bisha=Qal'at Bishah
Jeddah=Djeddah
Taif=Taëf
Mecca=La Mecque
Kharja=Khardja
Khamaseen=Khamsin
Haradh=Harad
Ardah=Alardah Alnajdiyah
Kuwait=Koweït
Aleppo=Alep
Idlib=Idleb
Latakia=Lattaquié
Kernaz=Karnaz
Homs‎=Homs
Tartus‎=Tartous
Beirut=Beyrouth
Daraa=Deraa
Ash Shaddadi=Al-Chaddadeh
Deir ez Zur=Deir ez-Zor
Al Mayadin=Mayadine
Ar Raqqah=Raqqa
Kobanî=Kobané
Khanaser=Khanasser
Al Nabk=An-Nabk
Rutba=Ar-Rutbah
Tulaiha=Bataille de Buzakha
Qa'im=Al-Qa'im
Baghdad=Bagdad
Karbala=Kerbala
Hillah=Hilla
Najaf=Nadjaf
Nasiriyah=An Nasiriya
Samawah=Samawa
Basrah=Bassorah
Amarah=Al-Amara
Al Diwaniyah=Diwaniya
Al Fallujah=Falloujah
Baqubah=Bakouba
Kirkuk=Kirkouk
Sulaymaniyah=Souleimaniye
Mosul=Mossoul
Duhok=Dohuk
Tal Afar=Tall Afar
Liaqatpur=Liaqauatpur
Derawar=Fort de Derawar
Kalam=Kalâm
Gogra=Karnali
Dharamshala=Dharamsala
Anuradhapura=Anurâdhapura
Trincomalee=Trinquemalay
Kochi=Cochin
Kollam=Quilon
Kannur=Cannanore
Mysuru=Mysore
Bengaluru=Bangalore
Mangaluru=Mangalore
Tumakuru=Tumkur
Shivamogga=Shimoga
Davanagere=Davangere
Chennai=Madras
Ballari=Bellary
Kalaburagi=Gulbarga
Beed=Bid
Ahmednagar=Ahmadnagar
Bagalkote=Bagalakote
Surat=Surate
Banswara=Bânsvâra
Pokhran=Pokharan
Khambhat=Cambay
Salasar=Salazar
Bareilly=Bareli
Chattogram=Chittagong
Dhaka=Dacca
Bogura=Bogra
Rajshahi=Râjshâhî
Khulna=Khulnâ
Kolkata=Calcutta
Sahibganj=Sahebganj
Thimphu=Thimphou
Berhampore=Baharampur
Puri=Purî
Singapore=Singapour
Jember=Kabupaten de Jember
Sintang=Kabupaten de Sintang
Berapi=Marapi
Palangkaraya=Palangka Raya
Sikan=Ras al-Aïn
Manila=Manille
Baler=Ramasseuse-presse
Infanta=Infant
Iloilo=Iloílo
Amami=Îles Amami
Yakushima=Yaku-shima
Kitakyushu=Kitakyūshū
Hyuga=Hyūga
Miyakonojo=Miyakonojō
Kochi=Cochin
Odate=Ōdate
Koriyama=Kōriyama
Hofu=Hōfu
Shobara=Shōbara
Koka=Kōka
Nowrangpur=Nabarangpur
Shahada=Chahada
Khajuraho=Khajurâho
Raigarh=Raigârh
Sundargarh=Sundergarh
Keonjhar=Kendujhar
Varanasi=Bénarès
Raebareli=Rae Bareli
El Jebha=Jebha
Bin Jawad=Ben Jawad
Ras Lanuf=Ras Lanouf
Cáceres‎=Cáceres
Peniscola=Peníscola
Andorra=Andorre
Balme=Barmes
Varese=Varèse
Thun=Thoune
Trikala=Tríkala
Farsala=Pharsale
Zagliveri=Zanglivéri
Izmail=Izmaïl
Ceska Lipa=Česká Lípa
Jesenik=Jeseník
Zamberk=Žamberk
The Hague=La Haye
Naumburg=Naumbourg
Schleswig=Duché de Schleswig
Ringkobing=Ringkøbing
Stolin=Stoline
Ivatsevichy=Ivatsevitchy
Pruzhany=Proujany
Lochcarron=Tòrr nan Clàr
Reading=Lecture
Nicosia=Nicosie
Sebekoro=Sébékoro
Mumbai=Bombay
Petai=Parkia speciosa
Havana=La Havane
San Cristobal=San Cristóbal
Playa Giron=Playa Girón
Sancti Spiritus=Sancti Spíritus
Camaguey=Camagüey
Guantanamo=Guantánamo
Holguin=Holguín
George Town=Georgetown
Cap Haitien=Cap-Haïtien
Santo Domingo=Saint-Domingue
Pablo García=Pablo Garcia
Tonalá=Tonala
Comitán=Comitán de Domínguez
Mexico=Mexique
El Naranjo=Naranjo
Danli=Danlí
Esteli=Estelí
Waspam=Waspán
San Ramon=San Ramón
Boquete=Bajo Boquete
Penonome=Penonomé
Garachine=Garachiné
Quibdo=Quibdó
Santo Domingo=Saint-Domingue
Pasto=San Juan de Pasto
Bogotá=Bogota
Trinidad=Trinité
Segovia=Ségovie
Tulua=Tuluá
Pizarro=Francisco Pizarro
Guamo=El Guamo
Granada=Grenade
El Vigía=Alberto Adriani
San Cristobal=San Cristóbal
Valencia=Valence
Carupano=Carúpano
Ocuri=Ocurí
Trinidad=Trinité
Porvenir=El Porvenir
El Cerrito=Cerrito
Camana=Camaná
Cusco=Cuzco
Ica=ICA
Chepen=Chepén
Iberia=Péninsule Ibérique
Constitucion=Constitución
Taupō=Taupo
Whanganui=Wanganui
Tākaka=Takaka
Kaikōura=Kaikoura
Wānaka=Wanaka
Dawei=Tavoy
Mawlamyine=Moulmein
Yangon=Rangoun
Taungoo=Taungû
Hinthada=Henzada
Pyay=Prome
Macau=Macao
Monstrance=Ostensoir
Corrente=Courante
Prado=Musée du Prado
Brasília=Brasilia
Busan=Pusan
Goheung=District de Goheung
Muan=District de Muan
Geochang=District de Geochang
Uljin=District de Uljin
Seoul=Séoul
Sejong=Sejong le Grand
Sariwon=Sariwŏn
Sinuiju=Sinŭiju
Sakchu=Sakju
Chongjin=Ch'ŏngjin
Rason=Rasŏn
Chunggang=Junggang
Hamhung=Hamhŭng
Tokchon=Tŏkch'ŏn
Huichon=Hŭich'ŏn
Hanoi=Hanoï
Haiphong=Haïphong
Viet Tri=Việt Trì
Đông Hà=Dông Hà
Huế=Hué
Quy Nhon=Quy Nhơn
Buon Ma Thuot=Buôn Ma Thuột
Bảo Lộc=District de Bảo Lộc
Phan Thiet=Phan Thiết
Ho Chi Minh=Hô Chi Minh
Dong Xoai=Đồng Xoài
Can Tho=Cần Thơ
Kampong Kdei=Spean Praptos
Krapeu=Chakhe
Keng Tung=Kengtung
Muse=Muses
Hsipaw=Thibaw
Kale=Chou frisé
Moreh=Mont Moréh
Danai=Danaos
Hpakan=Hpakant
Nase=Chondrostoma
Imphal=Imphāl
Kathmandu=Katmandou
Phôngsali=Phongsaly
Muang Xai=Muang Xay
Huay Xai=Houei Sai
Xayaboury=Sayaboury
Pakse=Paksé
Sekong=Sékong
Paksan=Paksane
Long Tieng=Long Tien
Macau=Macao
Guangzhou=Canton
Bijie=Préfecture de Bijie
Huize=Xian de Huize
Yaan=Ya'an
Tongren=Préfecture de Tongren
Dechang=Xian de Dechang
Huangshan=Monts Huang
Rucheng=Xian de Rucheng
Lantian=Xian de Lantian
Hukou=Huji
Yifeng=Xian de Yifeng
Huaiji=Xian de Huaiji
Nanjing=Nankin
Huaian=Huai'an
Laian=Xian de Lai'an
Baoying=Xian de Baoying
Haian=Xian de Hai'an
Yahe=Ayahuasca
Beijing=Pékin
Taian=Tai'an
Huangdao=District de Huangdao
Laoling=Leling
Zhonghu=Zhongdihu
Xixiang=Xian de Xixiang
Chernivtsi=Tchernivtsi
Kolomyya=Kolomya
Uzhhorod=Oujhorod
Khust=Khoust
Pochaiv=Potchaïv
Chervonohrad=Tchervonohrad
Lutsk=Loutsk
Varash=Varach
Lyuboml=Liouboml
Kyiv=Kiev
Chernihiv=Tchernihiv
Zhytomyr=Jytomyr
Borodyanka=Borodianka
Berdychiv=Berdytchiv
Kryzhopil=Kryjopil
Khmelnytskyi=Khmelnytskyï
Shepetivka=Chepetivka
Chortkiv=Tchortkiv
Dunaivtsi=Dounaïvtsi
Sharhorod=Charhorod
Uman=Ouman
Buky=Bouky
Cherkasy=Tcherkassy
Kropyvnytskyi=Kropyvnytskyï
Oleksandriya=Oleksandria
Nadlak=Nădlac
Odesa=Odessa
Ladyzhyn=Ladyjyn
Mykolaiv=Mykolaïv
Chulakivka=Tchoulakivka
Kryvyi Rih=Kryvyï Rih
Bashtanka=Bachtanka
Zaporizhzhia=Zaporijjia
Berdyans'k=Berdiansk
Mariupol=Marioupol
Kerch=Kertch
Feodosia=Théodosie
Sevastopol=Sébastopol
Yevpatoriya=Eupatoria
Dzhankoi=Djankoï
Ishun=Krasnoperekopsk
Bilmak=Kamianka
Heniches'k=Henitchesk
Mykolaiv=Mykolaïv
Phuket=Province de Phuket
Takua Pa=Amphoe Takua Pa
Phetburi=Phetchaburi
Sakon Nakhon=Sakhon Nakhon
Si Sa Ket=Si Saket
Urmia=Ourmia
Sanandaj=Sanandadj
Hamedan=Hamadan
Tehran=Téhéran
Karaj=Karadj
Rasht=Racht
Lahijan=Lahidjan
Behshahr=Behchahr
Qaem Shahr=Qaem-Chahr
Kashan=Kachan
Isfahan=Ispahan
Naeen=Nain
Aligudarz=Aligoudarz
Borujerd=Boroudjerd
Kuhdasht=Kouhdacht
Kermanshah=Kermanchah
Khorramshahr=Khorramchahr
Gachsaran=Gatchsaran
Shiraz=Chiraz
Yasuj=Yassoudj
Kazerun=Kazeroun
Abadeh=Abadé
Aspas=ASPAS
Shahreza=Chahreza
Izadkhast=Izadkhvast
Dezful=Dezfoul
Bushehr=Bouchehr
Lar=LAR
Jahrom=Djahrom
Karbala=Kerbala
Chah Bahar=Tchabahar
Mazatlan=Mazatlán
La Cruz=Cruz
Guanaceví=Guanacevi
San Luis Potosi=San Luis Potosí
Juquila=Santa Catarina Juquila
Port of Spain=Port-d'Espagne
Cumana=Cumaná
Berezhany=Berejany
Waratah=Telopea
George Town=Georgetown
Adelaide=Adélaïde
Gladstone=William Ewart Gladstone
Miles=Mille
St George=Georges de Lydda
Gilbert River=Rivière Gilbert
Mackay=MacKay
Emerald=Émeraude
Willows=Saule
Packsaddle=Bât
Flying Fox=Pteropus
Meadow=Prairie
Cervantes=Miguel de Cervantes
Denmark=Danemark
Nullarbor=Plaine de Nullarbor
Southern Cross=Croix du Sud
Cue=CUE
Karijini=Parc national de Karijini
Sandstone=Grès
Whangārei=Whangarei
Serres=Serrès
Kelibia=Kélibia
Gallipoli=Péninsule de Gallipoli
Caserta=Caserte
Bopo=Carte prépayée
St Lucia=Sainte-Lucie
Still Bay=Stilbaai
Gunza=Porto Amboim
Chio=Chios
Nijmegen=Nimègue
Winterthur=Winterthour
Kilkis=Kilkís
Didima=Didymes
Pilos=Pileus
Astros=Astros de Houston
Palairos=Páleros
Galaxidi=Galaxídi
Plakias=Plakiás
Çatalca=Tchataldja
Kiliya=Kilia
Yeysk=Ieïsk
Tiberias=Tibériade
Stoupa=Stoúpa
Obama=Barack Obama
Gammas=Gamma
San Sebastián=Saint-Sébastien
Ushuaia=Ushuaïa
Fuerte Bulnes=Fort Bulnes
Rio Gallegos=Río Gallegos
El Cerrito=Cerrito
Valdes=Valdez
Villalonga=Vilallonga
Río Colorado=Colorado
Neuquen=Neuquén
Lago Puelo=Lac Puelo
Casa Blanca=Casablanca
Zarate=Zárate
La Cruz=Cruz
Goya=Francisco de Goya
Paraná=Parana
América=États-Unis
Calingasta=Innanen
Formosa=Géographie de Taïwan
Orán=Oran
Santa María=Santa Maria
La Para=La Pare
Artigas=José Gervasio Artigas
Tacuarembo=Tacuarembó
Florida=Floride
Trinidad=Trinité
Blanquillo=Malacanthidae
Guichon=Guichón
Asunción=Asuncion
Dorado=Dorade
Jesuitas=Jesuítas
Palmito=Cœur de palmier
Concepcion=Concepción
Porvenir=El Porvenir
Bagua=Ba gua
Málaga=Malaga
Ciénaga=Ciénega
El Baul=El Baúl
Saul=Saül
Regina=Régina
Paradise=Paradis
Aurora=Aurore polaire
El Salvador=Salvador
Curico=Curicó
Los Ángeles=Los Angeles
Amambai=Amambaí
Bonito=Sardini
Xèrica=Jérica
Forli=Forlì
Hlybokaye=Hlybokaïe
Narač=Lac Naratch
Uzda=Ouzda
Stryi=Stryï
Vărșand=Pilu
Kozloduy=Kozlodouy
Megalopolis=Mégalopole
Tirnavos=Týrnavos
Grevena=Grevená
Florina=Flórina
Thermi=Thérmi
Shkodër=Scutari
Knjazevac=Knjaževac
Pancevo=Pančevo
Schaffhausen=Schaffhouse
Den Helder=Le Helder
Veurne=Furnes
Amel=Amblève
Éauze=Eauze
Novara=Novare
Pinerolo=Pignerol
Merano=Mérano
St Moritz=Saint-Moritz
Sidi Aissa=Sidi Aïssa
Mohammedia=Mohammédia
Medinine=Médenine
El Dorado=Eldorado
Manoa=Mānoa
Puerto la Cruz=Puerto La Cruz
Palermo=Palerme
Papaïchton=Papaichton
Uacari=Ouakari
Caruru=Carurú
Santo Antônio=Santo Antonio
Taboca=Chactas
Aracu=Araçu
Regina=Régina
Tiriós=Tiriyó
São Luiz=São Luís
Pitinga=Mine de Pitinga
Matisse=Henri Matisse
Urucu=Bixa
Tamanduá=Tamandua
Fuma=Fūma Kotarō
Breves=Brève
New Rome=Deuxième Rome
Bacaba=Oenocarpus bacaba
Bonito=Sardini
Estância=Estancia
Cobras=Cobra
Taboca=Chactas
Vila Rica=Ouro Preto
Ipê=Handroanthus
Vlașca=Vlaşca
Muting=Mute
Ofunato=Ōfunato
Dorud=Doroud
Nurabad=Nourabad
Hashtrud=Hachtroud
Bukan=Boukan
Baiji=Dauphin de Chine
Al Hasakah=Hassaké
Saraqib=Saraqeb
Shahba=Chahba
Rachaiya=Rachaya
Kerak=Al-Karak
Jenin=Jénine
Jericho=Jéricho
Chiriqui=Chiriquí
Tamarindo=Tamarinier
Roxana=Roxane
Usulutan=Usulután
El Paraiso=El Paraíso
Quimistan=Quimistán
Jalapa=Xalapa
Chacmool=Chac Mool
Coba=Cobá
Calkini=Calkiní
Monte Rosa=Mont Rose
Maruata=Waverley
Honey=Miel
Trinidad=Trinité
Venus=Vénus
Savannah=Savane
Athens=Athènes
Perry=Poiré
Andalusia=Andalousie
Troy=Troie
Panama City=Panama
New Orleans=La Nouvelle-Orléans
Buras=Burås
New Iberia=La Nouvelle-Ibérie
Meridian=Méridien
Kosciusko=Tadeusz Kościuszko
Warsaw=Varsovie
Radcliff=Radcliffe
Hazard=Danger
Athens=Athènes
Erie=Érié
Alexandria=Alexandrie
Philadelphia=Philadelphie
Woodstock=Festival de Woodstock
Bethel=Béthel
Lebanon=Liban
Farmville=FarmVille
Flint=Silex
Detroit=Détroit
Mt Pleasant=Mount Pleasant
Niagara Falls=Chutes du Niagara
London=Londres
Ironwood=Bois de fer
Virginia=Virginie
Sandstone=Grès
St Cloud=Saint Cloud
Alexandria=Alexandrie
Hague=La Haye
Cannon Ball=Cannonball
Butler=Bouteiller
Homeland=Patrie
Century=Siècle
Tupelo=Nyssa
Corinth=Corinthe
Grenada=Grenade
Vermillion=Vermillon
Faith=Foi
Wall=Mur
El Dorado=Eldorado
Kiowa=Kiowas
Beaver=Castor
Perry=Poiré
Choctaw=Chactas
Alexandria=Alexandrie
El Dorado=Eldorado
Hope=Espoir
Mason City=Mason
Mt Pleasant=Mount Pleasant
Atlantic=Océan Atlantique
Lebanon=Liban
Hayti=Haïti
Cape Girardeau=Cap Girardeau
Hannibal=Hannibal Barca
Bethany=Béthanie
Bolivar=Simón Bolívar
Metropolis=Métropole
Grants=Grant
Reserve=Réserve
Trinidad=Trinité
Boulder=Bloc
Walden=Walden ou la Vie dans les bois
Rye=Seigle
Cheyenne=Cheyennes
Powder River=Powder
Lake=Lac
Baker=Boulanger
Pray=Prière
Malta=Malte
Circle=Cercle
Jordan=Jordanie
Coeur d'Alene=Cœur d'Alène
Moscow=Moscou
Malta=Malte
Riddle=Énigme
Salmon=Saumon
Price=Prix
St. George=Georges de Lydda
Eureka=Eurêka
Moses Lake=Lac Moses
Republic=République
Forks=Fourchette
Sisters=Sœur
Brothers=Frère
Plush=Peluche
Baker=Boulanger
Alamo=Siège de Fort Alamo
Eureka=Eurêka
Globe=Globe terrestre
St Johns=Saint John's
Seligman=Seligmann
Nothing=Néant
Baker=Boulanger
Boron=Bore
Bishop=Évêque
San Jose=San José
Weed=Adventice
Peanut=Arachide
Fort Bragg=Fort Liberty
Canadian=Canadiens
Canyon=Gorge
Seminole=Séminoles
Spur=Éperon
Turkey=Turquie
Comanche=Comanches
West=Ouest
Athens=Athènes
El Rifle=Wálter Pandiani
Moctezuma=Montezuma
Villa Ahumada=Ahumada
San Nicolas=San Nicolás
Trail=Sentier
Pavilion=Pavillon
Red Deer=Cerf élaphe
Mildred Lake=Wood Buffalo
La Crête=La Crete
Gull Lake=Lac Gull
Orkney=Orcades
Regina=Régina
Assiniboia=District d'Assiniboia
Hudson Bay=Baie d'Hudson
Mallard=Canard colvert
Wales=Pays de Galles
Candle=Bougie
Galena=Galène
Bethel=Béthel
Chicken=Gallus gallus domesticus
Winisk=Rivière Winisk
Greater Sudbury=Grand Sudbury
Longlac=Greenstone
Dryden=John Dryden
Flanders=Flandre
Montreal=Montréal
Québec City=Québec
Cornwall=Cornouailles
Richibucto=Richibouctou
Churchill Falls=Chutes Churchill
Sept Iles=Sept-Îles
Gods River=Rivière Gods
Southend=Southend-on-Sea
Baker Lake=Lac Baker
Canyon=Gorge
Rancheria=Ranchería
Ross River=Rivière Ross
Carmacks=Carmack
Dawson City=Cité de Dawson
Tungsten=Tungstène
Toad=Crapaud
Polaris=Alpha Ursae Minoris
Arthur's Town=Arthur's Town
The Bluff=Bluff
Florida=Floride
Balfour Town=Balfour
Sirjan=Sirdjan
Rafsanjan=Rafsandjan
Jiroft=Djiroft
Bazman=Mont Bazman
Birjand=Birdjand
Qaen=Ghayen
Mashhad=Machhad
Torbat e Jam=Torbat-e Djam
Kashmar=Kachmar
Bojnurd=Bodjnourd
Shirvan=Chirvan
Quchan=Ghoutchan
Abarkuh=Abarkouh
Turkmenbashi=Türkmenbaşy
Derweze=Darvaza
Dashoguz=Daşoguz
Nukus=Noukous
Turkmenabat=Türkmenabat
Yoloten=Ýolöten
Ashgabat=Achgabat
Zaranj=Zarandj
Herat=Hérat
Spin Buldak=Spin Boldak
Gardez=Gardêz
Kabul=Kaboul
Taleqan=Taléghan
Kunduz=Kondoz
Baghlan=Baghlân
Sheberghan=Chéberghân
Bamyan=Bâmiyân
Bagram=Begrâm
Yelizovo=Ielizovo
Ivashka=Ilya Ivashka
Rytkuchi=Rytkoutchi
Uelen=Ouelen
Omsukchan=Omsouktchan
Ussuriysk=Oussouriïsk
Arsenyev=Arseniev
Lesozavodsk=Lessozavodsk
Luchegorsk=Loutchegorsk
Terney=Terneï
Agzu=Agzou
Birobidzhan=Birobidjan
Borzya=Borzia
Chernyshevsk=Tchernychevsk
Mogocha=Mogotcha
Irkutsk=Irkoutsk
Cheremkhovo=Tcheremkhovo
Ulan Ude=Oulan-Oudé
Turt=Turț
Hatgal=Khatgal
Ulaanbaatar=Oulan-Bator
Choir=Chorale
Chinggis=Gengis Khan
Altai=Altaï
Tes=TES
Hami=Préfecture de Hami
Turpan=Tourfan
Altay=Altaï
Barnaul=Barnaoul
Novosibirsk=Novossibirsk
Ordynskoye=Ordynskoïe
Rubtsovsk=Roubtsovsk
Belokurikha=Belokourikha
Biysk=Biïsk
Artybash=Artybach
Ongudai=Ongoudaï
Yazula=Iazoula
Bishkek=Bichkek
Balykchy=Balyktchy
Osh=Och
Jalal Abad=Djalalabad
Fergana=Ferghana
Karakalpakia=Karakalpakstan
Kantubek=Kantoubek
Urgench=Ourguentch
Turtkul=To‘rtko‘l
Gazli=Kozly
Zarafshan=Zeravchan
Uchkuduk=Outchkoudouk
Navoi=Navoï
Bukhara=Boukhara
Nurota=Nourata
Jizzakh=Djizak
Tashkent=Tachkent
Khujand=Khodjent
Qarshi=Karchi
Mubarek=Muborak
Denau=Denov
Istaravshan=Istaravchan
Panjakent=Pendjikent
Dushanbe=Douchanbé
Qurgonteppa=Bokhtar
Gharm=Garm
Tokhtamysh=Tokhtamych
Nepalgunj=Nepalganj
Jomsom=Jomoson
Arvaikheer=Arvayheer
Zharkent=Jarkent
Taldykorgan=Taldykourgan
Konaev=Kounaïev
Kuytun=Kuitun
Bayingolin=Bayangol
Alar=Daminozide
Talimu Pendi=Bassin du Tarim
Kashgar=Kachgar
Zepu=Xian de Poskam
Luobupo=Lob Nor
Gaotai=Xian de Gaotai
Baku=Bakou
Sumqayit=Sumqayıt
Mingecevir=Mingəçevir
Shirvan=Chirvan
Beylagan=Beyləqan
Nakhchivan=Nakhitchevan
Jermuk=Djermouk
Yerevan=Erevan
Artashat=Artaxata
Tbilisi=Tbilissi
Marneuli=Marneouli
Gudauri=Goudaouri
Borjomi=Bordjomi
Kutaisi=Koutaïssi
Batumi=Batoumi
Lanchkhuti=Lantchkhouti
Sokhumi=Soukhoumi
Aktau=Aktaou
Zhanaozen=Janaozen
Beyneu=Beïnéou
Kulsary=Koulsary
Shalkar=Chalkar
Aktobe=Aktioubé
Kandyagash=Kandyagach
Embi=Emba
Atyrau=Atyraou
Baikonur=Baïkonour
Turkistan=Turkestan
Merki=Merke
Shymkent=Chymkent
Karatau=Karataou
Shakhtinsk=Chakhtinsk
Shchuchinsk=Chtchoutchinsk
Kokshetau=Kokchetau
Ruzaevka=Rouzaïevka
Kostanay=Kostanaï
Borovskoy=Borovski
Zhetikara=Jitikara
Severnoye=Severny
Zhezqazghan=Jezqazğan
Baykonur=Baïkonour
Betpak Dala=Steppe de la Faim
Karazhal=Qarajal
Aktau=Aktaou
Bay=Baie
Ayagoz=Aïagouz
Urzhar=Ourdchar
Semey=Semeï
Kurshim=Kourchim
Oskemen=Öskemen
Ekibastuz=Ekibastouz
Ereymentau=Ereïmentaou
Makhachkala=Makhatchkala
Izberbash=Izberbach
Khunzakh=Khounzakh
Khasavyurt=Khassaviourt
Urus Martan=Ourous-Martan
Nalchik=Naltchik
Pyatigorsk=Piatigorsk
Tyrnyauz=Tyrnyaouz
Budyonnovsk=Boudionnovsk
Neftekumsk=Neftekoumsk
Kamyzyak=Kamyziak
Rostov on Don=Rostov-sur-le-Don
Bataysk=Bataïsk
Kropotkin=Pierre Kropotkine
Novorossiysk=Novorossiïsk
Gelendzhik=Guelendjik
Sochi=Sotchi
Maykop=Maïkop
Cherkessk=Tcherkessk
Surovikino=Sourovikino
Kamyshin=Kamychine
Akhtubinsk=Akhtoubinsk
Yashkul=Jaskul
Mirnyy=Mirny
Shostka=Chostka
Nizhyn=Nijyn
Pereiaslav=Pereïaslav
Pryluky=Prylouky
Lubny=Loubny
Zolotonosha=Zolotonocha
Kremenchuk=Krementchouk
Sumy=Soumy
Chuhuiv=Tchouhouïv
Izyum=Izioum
Luhansk=Louhansk
Severodonetsk=Sievierodonetsk
Shakhty=Chakhty
Krasnoyarsk=Krasnoïarsk
Achinsk=Atchinsk
Hadyach=Hadiatch
Ranua=Municipalité de Ranua
Murmansk=Mourmansk
Verkhnetulomsky=Verkhnetoulomski
Nadvoitsy=Vojatšu
Pudozh=Poudoj
Medvezhyegorsk=Medvejiegorsk
Pitkyaranta=Pitkiaranta
Suoyarvi=Souoïarvi
Repola=Reboly
Kostomuksha=Kostomoukcha
St Petersburg=Saint-Pétersbourg
Lodeynoye Pole=Lodeïnoïe Pole
Shlisselburg=Chlisselbourg
Kingisepp=Kingissepp
Samarkand=Samarcande
Kirishi=Kirichi
Veliky Novgorod=Novgorod
Staraya Russa=Staraïa Roussa
Siversky=Siverski
Pechory=Petchory
Opochka=Opotchka
Sebezh=Sebej
Velikiye Luki=Velikié Louki
Zharki=Żarki
Bryansk=Briansk
Moscow=Moscou
Rzhev=Rjev
Vyazma=Viazma
Velizh=Velij
Sergiyev Posad=Serguiev Possad
Yaroslavl=Iaroslavl
Vichuga=Vitchouga
Rostov=Rostov-sur-le-Don
Gryazovets=Griazovets
Poshekhonye=Pochekhonie
Cherepovets=Tcherepovets
Ustyuzhna=Oustioujna
Vesyegonsk=Vessiegonsk
Uglich=Ouglitch
Kalyazin=Kaliazine
Breitovo=Porc de Breïtovo
Bezhetsk=Bejetsk
Tikhvin=Tikhvine
Novouzensk=Novoouzensk
Yershov=Ierchov
Chapayevsk=Tchapaïevsk
Sorochinsk=Sorotchinsk
Orenburg=Orenbourg
Kumertau=Koumertaou
Ufa=Oufa
Tuymazy=Touïmazy
Bugulma=Bougoulma
Abdulino=Abdoulino
Ulyanovsk=Oulianovsk
Nizhnekamsk=Nijnekamsk
Naberezhnye Chelny=Naberejnye Tchelny
Chaykovsky=Tchaïkovski
Kudymkar=Koudymkar
Dobryanka=Dobrianka
Kungur=Koungour
Nizhny Tagil=Nijni Taguil
Izhevsk=Ijevsk
Sarapul=Sarapoul
Mozhga=Mojga
Kukmor=Koukmor
Yoshkar Ola=Iochkar-Ola
Yaransk=Iaransk
Cheboksary=Tcheboksary
Kanash=Kanach
Nizhny Novgorod=Nijni Novgorod
Kuvandyk=Kouvandyk
Sibay=Sibaï
Troitsk=Troïtsk
Chelyabinsk=Tcheliabinsk
Zlatoust=Zlatooust
Yekaterinburg=Iekaterinbourg
Polevskoy=Polevskoï
Ishim=Ichim
Tyumen=Tioumen
Yalutorovsk=Ialoutorovsk
Kurgan=Kourgane
Shadrinsk=Chadrinsk
Saluzzo=Saluces
Ilirney=Ilirneï
Chersky=Tcherski
Kadykchan=Kadyktchan
Verkhoyansk=Verkhoïansk
Batagay=Batagaï
Aim=AIM
Chulman=Tchoulman
Yakutsk=Iakoutsk
Dudinka=Doudinka
Torzhok=Torjok
Ostashkov=Ostachkov
Borovichi=Borovitchi
Udomlya=Oudomlia
Dubna=Doubna
Kaluga=Kalouga
Zhizdra=Jizdra
Lyudinovo=Lioudinovo
Medyn=Medyne
Serpukhov=Serpoukhov
Ryazan=Riazan
Nizhny Lomov=Nijni Lomov
Ruzayevka=Rouzaïevka
Oryol=Orel
Voronezh=Voronej
Yelets=Ielets
Kursk=Koursk
Zheleznogorsk=Jeleznogorsk
Trubchevsk=Troubtchevsk
Korocha=Korotcha
Boguchar=Bogoutchar
Buturlinovka=Boutourlinovka
Borisoglebsk=Borissoglebsk
Balashov=Balachov
Uryupinsk=Ourioupinsk
Veshenskaya=Vechenskaïa
Gryazi=Griazi
Michurinsk=Mitchourinsk
Lebedyan=Lebedian
Skopin=Skopine
Morshansk=Morchansk
Kuznetsk=Kouznetsk
Barysh=Barych
Sergach=Sergatch
Lukoyanov=Loukoïanov
Murom=Mourom
Sudogda=Soudogda
Kasimov=Kassimov
Sharya=Charia
Chukhloma=Tchoukhloma
Buy=BUY
Nyandoma=Niandoma
Shishkina=Chichkine
Shakhunya=Chakhounia
Obyachevo=Obiatchevo
Omutninsk=Omoutninsk
Usinsk=Oussinsk
Pechora=Petchora
Yamburg=Kingissepp
Novy Urengoy=Novy Ourengoï
Kuybyshev=Kouïbychev
Karasuk=Karassouk
Palochka=Palotchka
Vorkuta=Vorkouta
Nyagan=Niagan
Zarechnyy=Zaretchny
Khanty Mansiysk=Khanty-Mansiïsk
Surgut=Sourgout
Nefteyugansk=Nefteïougansk
Demyanka=Demianka
Turinsk=Tourinsk
Sovetsky=Sovetskaïa
Noyabrsk=Noïabrsk
Raduzhny=Radoujny
Lyantor=Liantor
Vorontsovka=Tachir
Mutina=Modène
Sayansk=Saïansk
Tayshet=Taïchet
Turukhansk=Touroukhansk
Noginsk=Noguinsk
Olekminsk=Oliokminsk
Togtoh=Xian de Togtoh
Yegoryevsk=Iegorievsk
Almetyevsk=Almetievsk
Pugachyov=Pougatchev
Lisakovsk=Lissakovsk
Gudauta=Goudaouta
Tuapse=Touapsé
Buynaksk=Bouïnaksk
Gebele=Qabala
Ijevan=Idjevan
Javanrud=Djavanroud
Saint Paul=Paul de Tarse
Boueni=Bouéni
Christmas Island=Île Christmas
Los Llanos=Llanos
Ain Temouchent=Aïn Témouchent
Az Zāwiyah=Zaouïa
Severo Kurilsk=Severo-Kourilsk
Urup=Ouroup
Kunashir=Kounachir
Nikolskoe=Nikolski
Helen Reef=Hatohobei
Tendoo=Tendō
Micronesia=Micronésie
Ba=BA
Wales=Pays de Galles
Komotini=Komotiní
Dahshur=Dahchour
Zarqa=Zarka
Drama=Drame
Giannitsa=Giannitsá
Tinos=Tínos
Sitia=Sitía
Palaiochora=Paleóchora
Lefkoniko=Lefkóniko
Baniyas=Banias
Çeşme=Tchesmé
Andros=Ándros
Coressia=Korésia
Sikinos=Síkinos
Leros=Léros
Ikaria=Ikaría
Tel Aviv=Tel Aviv-Jaffa
Ajloun=Ajlun
Al-Dumayr=Doumeir
Aarsal=Ersal
Shcholkine=Chtcholkine
Apsheronsk=Apcheronsk
Yuzhne=Youjne
Iturup=Itouroup