Lisbon=Lissabon
Dongola=Dunqula
Zaragoza=Saragossa
Saint George's=Saint George
León=Leon
Ávila‎=Ávila
Seville=Sevilla
Lucena=Lucena City
Alcoi=Alcoy
Mahón=Maó
Evora=Évora
Agrigento=Agrigent
Naples=Neapel
Taranto=Tarent
Rome=Rom
L'Aquila=L’Aquila
Florence=Florenz
Genoa=Genua
Venice=Venedig
Trieste=Triest
Bra=Büstenhalter
Milan=Mailand
Trento=Trient
Londonderry Derry=Derry
Portlaoise=Port Laoise
St Helier=Saint Helier
Nice=Nizza
Geneva=Genf
Dunkirk=Dunkerque
Strasbourg=Straßburg
Haguenau=Hagenau
Mulhouse=Mülhausen
Saintes=Saint
Liège=Lüttich
Ghent=Gent
Antwerp=Antwerpen
Bruges=Brügge
Luxembourg=Luxemburg
Lucerne=Luzern
Soelden=Sölden
Vienna=Wien
Gmünd=Gmund
Novo Mesto=Novo mesto
Trinec=Třinec
Olomouc=Olmütz
Brno=Brünn
Hradec Kralove=Hradec Králové
Karlovy Vary=Karlsbad
Prague=Prag
Mlada Boleslav=Mladá Boleslav
Ceske Budejovice=Budweis
Pisek=Písek
Gdańsk=Danzig
Warsaw=Warschau
Ciechanow=Ciechanów
Bielsko Biala=Bielsko-Biała
Kraków=Krakau
Wrocław=Breslau
Raciborz=Racibórz
Glogow=Głogów
Poznań=Posen
Szczecin=Stettin
Bialogard=Białogard
Sovetsk=Sowetsk
Chernyakhovsk=Tschernjachowsk
Bagrationovsk=Bagrationowsk
Svetlogorsk=Swetlogorsk
Frankfurt an der Oder=Frankfurt
Hanover=Hannover
Cologne=Köln
Frankfurt=Frankfurt
Wittenberg=Wittenberg
Nuremberg=Nürnberg
Arolsen=Bad Arolsen
Munich=München
Mühldorf=Mühldorf
Rain=Regen
Copenhagen=Kopenhagen
Gothenburg=Göteborg
Meraker=Meråker
Aluksne=Alūksne
Silene=Leimkräuter
Jekabpils=Jēkabpils
Ogre=Oger
Edineţ=Edineț
Chişinău=Chișinău
Rîbniţa=Rîbnița
Bucharest=Bukarest
Fetești Gară=Fetești
Caracal=Karakal
Sibiu=Hermannstadt
Plovdiv=Plowdiw
Haskovo=Chaskowo
Sliven=Sliwen
Dobrich=Dobritsch
Shumen=Schumen
Veliko Tarnovo=Weliko Tarnowo
Yambol=Jambol
Svilengrad=Swilengrad
Kardzali=Kardschali
Stara Zagora=Stara Sagora
Blagoevgrad=Blagoewgrad
Vratsa=Wraza
Vidin=Widin
Pleven=Plewen
Teteven=Tetewen
Koprivshtitsa=Kopriwschtiza
Sarandë=Saranda
Korçë=Korça
Vlorë=Vlora
Lezhë District=Kreis Lezha
Niksic=Nikšić
Belgrade=Belgrad
Mali Losinj=Mali Lošinj
Larissa=Larisa
Kalabaka=Kalambaka
Corfu=Korfu
Athens=Athen
Chalcis=Chalkida
Corinth=Korinth
Atalanti=Atalandi
Karpenissi=Karpenisi
Heraklion=Iraklio
Nafplion=Nafplio
Sparti=Sparta
Zakinthos=Zakynthos
İstanbul=Istanbul
Saray=Serail
İzmir=Izmir
Ordu=Altınordu
Hakkâri=Hakkari
Van=Kleintransporter
Elâzığ=Elazığ
Barysaw=Baryssau
Baranavichy=Baranawitschy
Grodno=Hrodna
Maladzyechna=Maladsetschna
Smarhoń=Smarhon
Vaŭkavysk=Waukawysk
Mazyr=Masyr
Gomel=Homel
Rečyca=Retschyza
Babruysk=Babrujsk
Žlobin=Schlobin
Svietlahorsk=Swetlahorsk
Žytkavičy=Schytkawitschy
Lelchytsy=Leltschyzy
Luninets=Luninez
Fanipaĺ=Fanipal
Mogilev=Mahiljou
Orsha=Orscha
Byerazino=Berasino
Krychaw=Krytschau
Slawharad=Slauharad
Bialyničy=Bjalynitschy
Viciebsk=Wizebsk
Lepiel=Lepel
Polatsk=Polazk
Braslaw=Braslau
Rasony=Rassony
Pastavy=Pastawy
Vileyka=Wilejka
Kaliningrad=Königsberg