Lisbon=Lizbona
Madrid=Madryt
Paris=Paryż
Zaragoza=Saragossa
Saint John's=St. John’s
Saint George's=Saint George
León=Leon
Salamanca=Salamanka
Ávila‎=Ávila
Segovia=Segowia
Pamplona=Pampeluna
San Sebastian=San Sebastián
Andorra=Andora
Vielha=Vielha e Mijaran
Valencia=Walencja
Cádiz=Kadyks
Seville=Sewilla
Jerez=Jerez de la Frontera
Málaga=Malaga
Granada=Grenada
Murcia=Murcja
Alcoi=Alcoy
Caravaca=Caravaca de la Cruz
Mahón=Maó
Evora=Évora
Messina=Mesyna
Lamezia=Lamezia Terme
Naples=Neapol
Taranto=Tarent
Benevento=Benewent
Rome=Rzym
L'Aquila=L’Aquila
Ancona=Ankona
Ravenna=Rawenna
Pisa=Piza
Florence=Florencja
Bologna=Bolonia
Genoa=Genua
Lucca=Lukka
Catania=Katania
Padua=Padwa
Verona=Werona
Trieste=Triest
Sanremo=San Remo
Turin=Turyn
Bra=Biustonosz
Milan=Mediolan
Pavia=Pawia
Trento=Trydent
Oxford=Oksford
London=Londyn
Edinburgh=Edynburg
Tórshavn=Thorshavn
St Helier=Saint Helier
Narbonne=Narbona
Avignon=Awinion
Marseille=Marsylia
Nice=Nicea
Monaco=Monako
Toulon=Tulon
Geneva=Genewa
Chamonix=Chamonix-Mont-Blanc
Le Havre=Hawr
Dunkirk=Dunkierka
Versailles=Wersal
Strasbourg=Strasburg
Mulhouse=Miluza
Toulouse=Tuluza
Bayonne=Bajonna
Saintes=Saint
Orléans=Orlean
Ghent=Gandawa
Antwerp=Antwerpia
Bruges=Brugia
Luxembourg=Luksemburg
Zürich=Zurych
Basel=Bazylea
Bern=Berno
Lucerne=Lucerna
Lausanne=Lozanna
St Gallen=St. Gallen
Konstanz=Konstancja
Fribourg=Fryburg
Soelden=Sölden
Bregenz=Bregencja
Vienna=Wiedeń
St Pölten=St. Pölten
Gmünd=Gmund
Ljubljana=Lublana
Novo Mesto=Novo mesto
Budapest=Budapeszt
Miskolc=Miszkolc
Debrecen=Debreczyn
Szeged=Segedyn
Pécs=Pecz
Bratislava=Bratysława
Trnava=Trnawa
Žilina=Żylina
Trenčín=Trenczyn
Lučenec=Łuczeniec
Banská Bystrica=Bańska Bystrzyca
Ružomberok=Rużomberk
Prešov=Preszów
Košice=Koszyce
Bardejov=Bardejów
Rožňava=Rożniawa
Ostrava=Ostrawa
Trinec=Trzyniec
Opava=Opawa
Olomouc=Ołomuniec
Zlín=Zlin
Hradec Kralove=Hradec Králové
Teplice=Cieplice
Karlovy Vary=Karlowe Wary
Prague=Praga
Mlada Boleslav=Mladá Boleslav
Ceske Budejovice=Czeskie Budziejowice
Jihlava=Igława
Pisek=Písek
Warsaw=Warszawa
Ciechanow=Ciechanów
Bielsko Biala=Bielsko-Biała
Raciborz=Racibórz
Glogow=Głogów
Bialogard=Białogard
Kaliningrad=Królewiec
Gusev=Gusiew
Sovetsk=Sowietsk
Chernyakhovsk=Czerniachowsk
Bagrationovsk=Bagrationowsk
Bremen=Brema
Kiel=Kilonia
Lübeck=Lubeka
Frankfurt an der Oder=Frankfurt nad Odrą
Cottbus=Chociebuż
Potsdam=Poczdam
Braunschweig=Brunszwik
Hanover=Hanower
Cologne=Kolonia
Göttingen=Getynga
Leipzig=Lipsk
Dresden=Drezno
Frankfurt=Frankfurt nad Menem
Wittenberg=Wittenberga
Bautzen=Budziszyn
Nuremberg=Norymberga
Aachen=Akwizgran
Trier=Trewir
Koblenz=Koblencja
Mainz=Moguncja
Arolsen=Bad Arolsen
Giessen=Gießen
Speyer=Spira
Munich=Monachium
Regensburg=Ratyzbona
Mühldorf=Mühldorf am Inn
Passau=Pasawa
Rain=Deszcz
Freiburg im Breisgau=Fryburg Bryzgowijski
Copenhagen=Kopenhaga
Gothenburg=Göteborg
Stockholm=Sztokholm
Meraker=Meråker
Narva=Narwa
Pärnu=Parnawa
Aluksne=Alūksne
Rēzekne=Rzeżyca
Ludza=Lucyn
Daugavpils=Dyneburg
Silene=Lepnica
Aglona=Agłona
Jekabpils=Jēkabpils
Riga=Ryga
Jelgava=Jełgawa
Ogre=Ogr
Liepāja=Lipawa
Ventspils=Windawa
Jūrmala=Jurmała
Klaipėda=Kłajpeda
Palanga=Połąga
Plungė=Płungiany
Telšiai=Telsze
Mažeikiai=Możejki
Šiauliai=Szawle
Panevėžys=Poniewież
Biržai=Birże
Tauragė=Taurogi
Pagėgiai=Pojegi
Vilnius=Wilno
Kaunas=Kowno
Marijampolė=Mariampol
Alytus=Olita
Lazdijai=Łoździeje
Ukmergė=Wiłkomierz
Utena=Uciana
Zarasai=Jeziorosy
Visaginas=Wisaginia
Jonava=Janów
Kėdainiai=Kiejdany
Bălți=Bielce
Soroca=Soroki
Edineţ=Jedyńce
Chişinău=Kiszyniów
Tiraspol=Tyraspol
Rîbniţa=Rybnica
Cimişlia=Cimișlia
Cahul=Kaguł
Iași=Jassy
Bucharest=Bukareszt
Constanța=Konstanca
Tulcea=Tulcza
Brăila=Braiła
Galați=Gałacz
Focșani=Fokszany
Ploiești=Ploeszti
Craiova=Krajowa
Caracal=Karakal stepowy
Sibiu=Sybin
Orșova=Orszowa
Cluj Napoca=Kluż-Napoka
Bistrița=Bystrzyca
Suceava=Suczawa
Botoșani=Botoszany
Brașov=Braszów
Plovdiv=Płowdiw
Haskovo=Chaskowo
Sliven=Sliwen
Dobrich=Dobricz
Shumen=Szumen
Veliko Tarnovo=Wielkie Tyrnowo
Yambol=Jamboł
Svilengrad=Swilengrad
Kardzali=Kyrdżali
Blagoevgrad=Błagojewgrad
Vratsa=Wraca
Vidin=Widyń
Pleven=Plewen
Teteven=Tetewen
Koprivshtitsa=Kopriwsztica
Ohrid=Ochryda
Gevgelija=Gewgelija
Kočani=Koczani
Sarandë=Saranda
Korçë=Korcza
Vlorë=Wlora
Lezhë District=Okręg Lezha
Niksic=Nikšić
Peja=Peć
Pristina=Prisztina
Ferizaj=Uroševac
Belgrade=Belgrad
Novi Sad=Nowy Sad
Zagreb=Zagrzeb
Sarajevo=Sarajewo
Dubrovnik=Dubrownik
Mali Losinj=Mali Lošinj
Thessaloniki=Saloniki
Serres=Seres
Kavala=Kawala
Alexandroupoli=Aleksandropolis
Xanthi=Ksanti
Veria=Weria
Ioannina=Janina
Larissa=Larisa
Kalabaka=Kalambaka
Igoumenitsa=Igumenitsa
Corfu=Korfu
Athens=Ateny
Chalcis=Chalkida
Istiaia=Istiea
Karystos=Karistos
Corinth=Korynt
Delphi=Delfy
Volos=Wolos
Karpenissi=Karpenisi
Agios Nikolaos=Ajos Nikolaos
Nafplion=Nauplion
Sparti=Sparta
Zakinthos=Zakintos
Gelibolu=Gallipoli
İstanbul=Stambuł
İzmir=Izmir
Antakya=Antiochia
Doğubeyazıt=Doğubayazıt
Elâzığ=Elazığ
Minsk=Mińsk
Barysaw=Borysów
Baranavichy=Baranowicze
Druskininkai=Druskieniki
Maladzyechna=Mołodeczno
Smarhoń=Smorgonie
Slonim=Słonim
Vaŭkavysk=Wołkowysk
Pinsk=Pińsk
Kobryn=Kobryń
Mazyr=Mozyrz
Gomel=Homel
Rečyca=Rzeczyca
Babruysk=Bobrujsk
Žlobin=Żłobin
Chachersk=Czeczersk
Svietlahorsk=Swietłahorsk
Salihorsk=Soligorsk
Hlusk=Hłusk
Žytkavičy=Żytkowicze
Lelchytsy=Lelczyce
Luninets=Łuniniec
Fanipaĺ=Fanipal
Mogilev=Mohylew
Orsha=Orsza
Byerazino=Berezyna
Krychaw=Krzyczew
Slawharad=Sławograd
Bialyničy=Białynicze
Viciebsk=Witebsk
Lepiel=Lepel
Syanno=Sienno
Polatsk=Połock
Braslaw=Brasław
Rasony=Rossony
Pastavy=Postawy
Vileyka=Wilejka
Venice=Wenecja
Al Hoceima=Al-Husajma
Tetouan=Tetuan
Tangier=Tanger
Kenitra=Al-Kunajtira
Fes=Fez
Oujda=Wadżda
Larache=Al-Ara’isz
Guelmim=Kulmim
Taroudant=Tarudant
Mhamid=Amhamid al-Ghizlan
Errachidia=Ar-Raszidijja
Midelt=Midalt
Khenifra=Chunajfira
Khemisset=Al-Chamisat
Marrakesh=Marrakesz
Khouribga=Churibka
Settat=Sattat
El Jadida=Al-Dżadida
Zemamra=Zamamira
Ouarzazate=Warzazat
Bizerte=Bizerta
El Kef=Al-Kaf
Sousse=Susa
Sfax=Safakis
Kairouan=Kairuan
Kasserine=Al-Kasrajn
Maktar=Maksar
Gafsa=Kafsa
Tozeur=Tauzar
Douz=Duz
Tataouine=Tatawin
Ksar Ghilane=Kasr Ghilan
Zarzis=Dżardżis
Gabes=Kabis
Tlemcen=Tilimsan
Saïda=Sa’ida
Tiaret=Tijarat
Awsard=Ausard
Tichla=Tiszla
Bir Gandouz=Bir Kanduz
Al Mahbes=Al-Mahbas
Bir Lehlou=Al-Bir al-Hilw
Laayoune=Al-Ujun
Guelta Zemmur=Kaltat Zammur
Bu Craa=Bukra
Bir Moghrein=Bir Umm Karajn
Fderik=Fudajrik
Choum=Szum
Ouadane=Wadan
Chinguetti=Szinkit
Akjoujt=Akdżawadżat
Nouakchott=Nawakszut
Nouadhibou=Nawazibu
Rosso=Rusu
Aleg=Alak
Boutilimit=Bu Tilimit
Sélibaby=Silibabi
Kiffa=Kifa
Sangrave=Sankrafa
Tidjikja=Tidżikdża
Tichit=Tiszit
Timbédra=Timbadgha
Néma=An-Nama
Walatah=Walata
Adel Bagrou=Adl Bakru
Ayoun el Atrous=Ujun al-Atrus
Banjul=Bandżul
Velingara=Vélingara
Kedougou=Kédougou
St Louis=Saint Louis
Nova Lamego=Gabú
Conakry=Konakry
Forecariah=Forécariah
Tougue=Tougué
Nzerekore=Nzérékoré
Gueckedou=Guéckédou
Kerouane=Kérouane
Abidjan=Abidżan
Yamoussoukro=Jamusukro
Soubre=Soubré
Duekoue=Duékoué
Adzope=Adzopé
Bouake=Bouaké
Tiebissou=Tiébissou
Tingrela=Tengréla
Odienne=Odienné
Seguela=Séguéla
Sokode=Sokodé
Kpalime=Kpalimé
Atakpame=Atakpamé
Tamale=Tamal
Ho=HO
Accra=Akra
Takoradi=Sekondi-Takoradi
Glazoue=Glazoué
Bante=Bantè
Kouande=Kouandé
Brass=Mosiądz
Benin City=Benin
Ore=Ruda
Abuja=Abudża
Nasarawa=Nassarawa
Bauchi=Bauczi
Jos=Dżos
Babana=Băbana
Gembu=Czarny Żółw
Langtang=Park Narodowy Langtang
Douala=Duala
Buea=Buéa
Yaoundé=Jaunde
Mamfe=Mamfé
Nsork=Nsok
Ngaoundere=Ngaoundéré
Meiganga=Meïganga
Mekambo=Mékambo
Ndjole=Ndjolé
Ndende=Ndendé
Kinshasa=Kinszasa
Kelle=Kellé
Sembe=Sembé
Ouesso=Ouésso
Cape Town=Kapsztad
Bethlehem=Betlejem
Hanover=Hanower
Carnarvon=Caernarvon
Springbok=Skocznik antylopi
Mbombela=Nelspruit
Piet Retief=Pieter Retief
Kanye=Kanye West
Selebi Phikwe=Selebi-Pikwe
Vilankulos=Vilankulo
Massinga=(760) Massinga
Chepica=Chépica
Estima=Toyota Previa
Mutala=Ylöjärvi
Gurue=Gurúè
Ribaue=Ribáuè
Windhoek=Windhuk
Maltahohe=Maltahöhe
Grunau=Grünau
Luderitz=Lüderitz
Bujumbura=Bużumbura
Arusha=Arusza
Luweero=Luwero
Kismayo=Kismaju
Mogadishu=Mogadiszu
Merca=Marka
Bardere=Baardheere
Baidoa=Baydhabo
Buur Hakaba=Buur Gaabo
Galkayo=Gaalkacyo
Harardhere=Xarardheere
Harardhere=Xarardheere
Garowe=Garoowe
Bosaso=Boosaaso
Taleh=Taleex
Buhodle=Buuhoodle
Laascaanood=Laas Caanood
Oodweyne=Codweyne
Hargeisa=Hargejsa
Borama=Boorama
Hadiboh=Hadibu
Djibouti‎=Dżibuti
Denan=Simwastatyna
Degeh Bur=Degehabur
Karat=Próba złota
Arba Minch=Arba Myncz
Hawassa=Auasa
Harar=Harer
Jijiga=Dżidżiga
Aysha=A’isza bint Abi Bakr
Dire Dawa=Dire Daua
Jimma=Dżimma
Jinka=Dżinka
Mekele=Mekelie
Adwa=Adua
Gondar=Gonder
Weldiya=Ueldija
Namibe=Moçâmedes
N'dalatando=N’dalatando
Uige=Uíge
N'zeto=N’zeto
Leua=Léua
Mutumbo=Dikembe Mutombo
Panga=Pangafer
Dembi Dolo=Dembidolo
Nekemte=Nekemtie
Addis Ababa=Addis Abeba
Debre Birhan=Debre Byrhan
Asayita=Asajta
Bahir Dar=Bahyr Dar
Nefas Mewcha=Nefas Mewcza
Dangla=Tanggula Shanmai
Juba=Dżuba
Bangui=Bangi
N'Délé=Ndélé
Dedougou=Dédougou
Ouagadougou=Wagadugu
San=SAN
Djenne=Dżenne
Birnin Konni=Birni N’Konni
Tânout=Tanout
N'Djamena=Ndżamena
Abeche=Abéché
Aouzou=Strefa Aouzou
Al Fashir=Al-Faszir
Zalingei=Zalindżi
Nyala=Niala grzywiasta
El Daein=Ad-Duwajm
Kadugli=Kadukli
Sennar=Sannar
Sinjah=Sindża
Al Qadarif=Al-Kadarif
Tendelti=Tandalti
Khartoum=Chartum
Ad Douiem=Ad-Duwajm
Al Manaqil=Al-Manakil
Suakin=Sawakin
Abri=Koleba skalna
Al Dabbah=Ad-Dabba
Shendi=Szandi
El Obeid=Al-Ubajjid
Barah=Bara
En Nahud=An-Nuhud
Halayeb=Hala’ib
Aswan=Asuan
Birein=Birajn
Safaga=Safadża
Qena=Kina
Sohag=Sauhadż
Girga=Dżirdża
Asyut=Asjut
Beni Suef=Bani Suwajf
Faiyum=Fajum
Ras Ghareb=Ras Gharib
Nebk=Dwukolczak śródziemnomorski
Arish=Al-Arisz
Nekhel=Nachl
Mansoura=Al-Mansura
Cairo=Kair
Zagazig=Az-Zakazik
Alexandria=Aleksandria
Damanhour=Damanhur
Sallum=As-Sallum
Siwa Oasis=Siwa
Farafra=Al-Farafira
Kharga=Charga
Bawiti=Al-Bawiti
Garyan=Gharjan
Zliten=Zalitan
Sirte=Syrta
Ajdabiya=Adżdabija
Benghazi=Bengazi
Al Marj=Al-Mardż
Al Jaghbub=Al-Dżaghbub
El Ezzeiat=Al-Izzijat
Al Jawf=Al-Dżauf
Murzuq=Murzuk
Qatrun=Al-Katrun
Rusevo=Ruševo
Zintan=Az-Zintan
Ghat=Ghaty
Awbari=Aubari
Tebessa=Tibissa
Souk Ahras=Suk Ahras
Skikda=Sukajkida
Batna=Batina
Khenchela=Chanszala
Béjaïa=Bidżaja
Jijel=Dżidżal
Setif=Satif
Bordj Bou Arreridj=Burdż Bu Urajridż
Biskra=Biskira
Bou Saada=Bu Sa’ada
Algiers=Algier
Blida=Al-Bulajda
Telagh=Talagh
El Bayadh=Al-Bajad
Mecheria=Al-Maszrijja
Mascara=Tusz do rzęs
Sidi Bel Abbès=Sidi Bu-l-Abbas
Béchar=Baszszar
Abadla=Al-Abadila
Ghardaia=Ghardaja
Ouargla=Warkala
Touggourt=Tukkurt
El Oued=Al-Wadi
Laghouat=Al-Aghwat
Djelfa=Dżilfa
Aïn Oussera=Ajn Wisara
Bouira=Al-Buwajra
Miliana=Miljana
Tipaza=Tipasa
Mostaganem=Mustaghanim
Relizane=Ghulajzan
Chlef=Szalif
Timimoun=Timimun
In Salah=Ajn Salih
Aoulef=Aulaf
Tindouf=Tinduf
Abalessa=Abalasa
Djanet=Dżanat
In Amenas=In Amnas
Seluka=Sülüktü
Sile=Şile
Mide=Królestwo Mide
Taolagnaro=Tôlanaro
Antananarivo=Antananarywa
Saka=Sakowie
Belo Tsiribihina=Belon’i Tsiribihina
Zinjibar=Zindżibar
Taizz=Ta’izz
Sana'a=Sana
Al Hudaydah=Al-Hudajda
Sa'dah=Sada
Shabwah=Szabwa
Ataq=Atak
Ash Shihr=Asz-Szihr
Seiyun=Sajun
Al Ghaydah=Al-Ghajda
Salalah=Salala
Sadah=Sada
Muscat=Maskat
Al Ain=Al-Ajn
Sohar=Suhar
Dubai=Dubaj
Fujairah=Fudżajra
Khasab=Chasab
Ras Al-Khaimah=Ras al-Chajma
Abu Dhabi=Abu Zabi
Be'er Sheva=Beer Szewa
Haifa=Hajfa
Al Mafraq=Al-Mafrak
Ruwaished=Ar-Ruwajszid
Azraq=Al-Azrak asz-Szamali
Ma'an=Ma’an
Aqaba=Akaba
Shobak=Montreal
Kerak=Al-Karak
Yotvata=Jotwata
Netivot=Netiwot
Acre=Akr
Damascus=Damaszek
Ashkelon=Aszkelon
Jerusalem=Jerozolima
Turaif=Turajf
Hail=Grad
Jubbah=Saub
Buraydah=Burajda
Unayzah=Unajza
Medina=Medyna
Yanbu=Janbu
Umluj=Umm Ladżdż
Khaybar=Chajbar
Tayma=Tajma
AlUla=Al-Ula
Al Wajh=Al-Wadżh
Haql=Hakl
Kilwa=Kilwa Kisiwani
Khafji=Al-Chafdżi
Al Jubail=Al-Dżubajl
Dammam=Ad-Dammam
Al Hofuf=Al-Hufuf
Riyadh=Rijad
Al Kharj=Al-Chardż
Al Majma'ah=Al-Madżma’a
Ranyah=Ranja
Bisha=Bisza
Al Qunfudhah=Al-Kunfuza
Al Lith=Al-Lis
Al Bahah=Al-Baha
Jeddah=Dżudda
Taif=At-Ta’if
Mecca=Mekka
Najran=Nadżran
As Sulayyil=As-Sulajjil
Hafar Al Batin=Hafr al-Batin
Kharja=Jarcha
Khamaseen=Khamsin
Ardah=Arda
Kuwait=Kuwejt
Kernaz=Kurnaz
Homs‎=Hims
Tartus‎=Tartus
Beirut=Bejrut
Daraa=Dara
Salkhad=Salchad
Ad Darbasiyah=Ad-Dirbasijja
Ash Shaddadi=Asz-Szaddada
Deir ez Zur=Dajr az-Zaur
Al Mayadin=Al-Majadin
Ar Raqqah=Ar-Rakka
Kobanî=Ajn al-Arab
Manbij=Manbidż
Khanaser=Chanasir
Khunayfis=Chunajfis
Al Nabk=An-Nabk
Rutba=Ar-Rutba
Ramadi=Ar-Ramadi
Haditha=Al-Hadisa
Baghdad=Bagdad
Hillah=Al-Hilla
Najaf=An-Nadżaf
Nasiriyah=An-Nasirijja
Samawah=As-Samawa
Basrah=Basra
Amarah=Al-Amara
Shatrah=Asz-Szatra
Kut=Al-Kut
Al Diwaniyah=Ad-Diwanijja
Al Fallujah=Al-Falludża
Baqubah=Bakuba
Khanaqin=Chanakin
Erbil=Irbil
Sulaymaniyah=As-Sulajmanijja
Amerli=Amirli
Hawija=Al-Hawidża
Duhok=Dahuk
Tal Afar=Tall Afar
Sinjar=Sindżar
Thamil=Tamilowie
Karachi=Karaczi
Hyderabad=Hajdarabad
Chor=Chór
Liaqatpur=Lijakatpur
Faisalabad=Fajsalabad
Gujranwala=Gudźranwala
Lahore=Lahaur
Sialkot=Sijalkot
Peshawar=Peszawar
Srinagar=Śrinagar
Jammu=Dżammu
Miran Shah=Miranszah
Noshki=Nuśki
Quetta=Kweta
Chaman=Ćaman
Layyah=Lajjah
Chitral=Czitral
Gogra=Ghaghra
Dharamshala=Dharamsala
Jalandhar=Dźalandhar
Ludhiana=Ludhijana
Colombo=Kolombo
Trincomalee=Trikunamalaja
Jaffna=Dżafna
Batticaloa=Madakalapuwa
Dambulla=Dambula
Nagercoil=Nagarkoil
Tirunelveli=Tirunelweli
Madurai=Maduraj
Thanjavur=Tańdźawur
Tiruchirappalli=Tiruchirapalli
Kochi=Koczin
Thrissur=Triśur
Tumakuru=Tumkur
Davanagere=Dawangere
Chennai=Ćennaj
Nellore=Nellur
Vijayawada=Widźajawada
Hyderabad=Hajdarabad
Nanded=Nander
Kurnool=Karnulu
Raichur=Rajćur
Bagalkote=Bagalkot
Ahmedabad=Ahmadabad
Jaisalmer=Dźajsalmer
Pali=Język pali
Jodhpur=Dźodhpur
Ajmer=Adźmer
Chittorgarh=Chittaurgarh
Udaipur=Udajpur
Junagadh=Dźunagadh
Salasar=Salazar
New Delhi=Nowe Delhi
Bareilly=Bareli
Joshimath=Jyotirmath
Kotdwar=Kotdwara
Chattogram=Ćottogram
Sylhet=Srihotto
Dinajpur=Dinadźpur
Bogura=Bogra
Rajshahi=Radźszahi
Satkhira=Szatkhira
Kushtia=Kusztija
Sahibganj=Sahebganj
Jakar=Dzakar
Hazaribagh=Hazaribag
Berhampore=Baharampur
Rourkela=Rurkela
Singapore=Singapur
Malacca=Malakka
Surabaya=Surabaja
Jakarta=Dżakarta
Berapi=Marapi
Palangkaraya=Palangka Raya
Sikan=Ras al-Ajn
Taipei=Tajpej
Taichung=Taizhong
Hsinchu=Xinzhu
Baler=Prasa
Infanta=Infant
Roxas City=Roxas
Ozamiz=Ozamis
Yakushima=Yaku-shima
Kitakyushu=Kitakiusiu
Miyakonojo=Miyakonojō
Kochi=Koczin
Tokushima=Prefektura Tokushima
Odate=Ōdate
Koriyama=Kōriyama
Tokyo=Tokio
Yokohama=Jokohama
Nagoya=Nagoja
Kyoto=Kioto
Hofu=Hōfu
Hiroshima=Hiroszima
Shobara=Shōbara
Toyooka=Toyo’oka
Jagdalpur=Dźagdalpur
Bijapur=Vijayapura
Chandrapur=Ćandrapur
Amravati=Amarawati
Shahada=Szahada
Gwalior=Gwalijar
Shivpuri=Śiwapuri
Raigarh=Rajgarh
Varanasi=Waranasi
Prayagraj=Prajagradź
Arrah=Arra
El Jebha=Al-Dżabha
Berkane=Barkan
El Aricha=Al-Arisza
Cheria=Asz-Szaria
Bin Jawad=Bin Dżawwad
Ras Lanuf=Ras al-Unuf
Cáceres‎=Cáceres
Peniscola=Peñíscola
Andorra=Andora
Peshkopi=Peshkopia
Niš=Nisz
Izmail=Izmaił
Ceska Lipa=Česká Lípa
Třeboň=Trzeboń
Jesenik=Jesionik
Zamberk=Žamberk
The Hague=Haga
Lübben=Lubin
Schleswig=Księstwo Szlezwiku
Ringkobing=Ringkøbing
Stenlille=Gmina Stenlille
Kelmė=Kielmy
Raseiniai=Rosienie
Šakiai=Szaki
Joniškis=Janiszki
Begoml=Biehomla
Stowbtsy=Stołpce
Malaryta=Małoryta
Ivatsevichy=Iwacewicze
Pruzhany=Prużana
Lahišyn=Łohiszyn
Reading=Czytanie
Rhodes=Rodos
Nicosia=Nikozja
Larnaca=Larnaka
Suluq=Suluk
Mumbai=Mumbaj
Petai=Parkia wspaniała
Chiayi=Jiayi
Havana=Hawana
San Cristobal=San Cristóbal
Playa Giron=Playa Girón
Sancti Spiritus=Sancti Spíritus
Camaguey=Camagüey
Guantanamo=Guantánamo
Holguin=Holguín
George Town=Georgetown
Cap Haitien=Cap-Haïtien
Palenque=Park Narodowy Palenque
Tenosique=Tenosique de Pino Suárez
Comitán=Comitán de Domínguez
Mexico=Meksyk
Guatemala=Gwatemala
Ixcan=Ixcán
Danli=Danlí
León=Leon
Esteli=Estelí
San José=San Jose
San Ramon=San Ramón
David=Dawid
Penonome=Penonomé
Riohacha=Ríohacha
Quibdo=Quibdó
Macara=Macará
Bogotá=Bogota
Trinidad=Trynidad
Segovia=Segowia
Tulua=Tuluá
Pizarro=Francisco Pizarro
Granada=Grenada
San Cristobal=San Cristóbal
Valencia=Walencja
Puerto La Cruz=Puerto la Cruz
Carupano=Carúpano
Trinidad=Trynidad
Porvenir=El Porvenir
Camana=Camaná
Cusco=Cuzco
Iberia=Półwysep Iberyjski
Constitucion=Constitución
Fátima=Fatima
Taupō=Taupo
Whanganui=Wanganui
Tākaka=Takaka
Kaikōura=Kaikoura
Wānaka=Wanaka
Nangin=Nangeen
Dawei=Tawè
Mawlamyine=Mulmejn
Yangon=Rangun
Thaton=Thatôn
Phyu=Pyu
Taungoo=Taungngu
Pathein=Basejn
Pyay=Pyain
Macau=Makau
Monstrance=Monstrancja
Corrente=Courante
Curitiba=Kurytyba
Vitoria=Vitória
Busan=Pusan
Incheon=Inczon
Seoul=Seul
Sejong=Sejong Wielki
Cheorwon=Ch’ŏrwŏn
Pyongyang=Pjongjang
Sariwon=Sariwŏn
Wonsan=Wŏnsan
Pyonggang=P’yŏnggang
Pyongsan=P’yŏngsan
Kusong=Kusŏng
Sinuiju=Sinŭiju
Sakchu=Sakju
Chongjin=Ch’ŏngjin
Rason=Rasŏn
Paekam=Paek’am
Wiwon=Wiwŏn
Sinhung=Sinhŭng
Hamhung=Hamhŭng
Sinpo=Sinp’o
Tokchon=Tŏkch’ŏn
Huichon=Hŭich’ŏn
Haiphong=Hajfong
Viet Tri=Việt Trì
Da Nang=Đà Nẵng
Quy Nhon=Quy Nhơn
Buon Ma Thuot=Buôn Ma Thuột
Phan Thiet=Phan Thiết
Ho Chi Minh=Hồ Chí Minh
Dong Xoai=Đồng Xoài
Can Tho=Cần Thơ
Cao Lãnh=Cao Lanh
Krong Kaeb=Kêb
Sisophon=Sisŏphŏn
Meiktila=Miktila
Aunglan=Myede
Monywa=Munywa
Mandalay=Mandalaj
Keng Tung=Kengtung
Lashio=Lasho
Muse=Muzy
Kale=Jarmuż
Hakha=Haka
Moreh=Giwat ha-More
Bhamo=Banmaw
Danai=Danaos
Hpakan=Hpakant
Nase=Chondrostoma
Kathmandu=Katmandu
Janakpur=Dźanakpur
Muang Xai=Muang Xay
Huay Xai=Ban Houayxay
Xayaboury=Muang Xaignabouli
Vientiane=Wientian
Attapeu=Attapu
Pakse=Pakxé
Sekong=Ban Phone
Savannakhet=Savannakhét
Paksan=Pakxan
Hong Kong=Hongkong
Macau=Makau
Guangzhou=Kanton
Yaan=Ya’an
Huangshan=Huang Shan
Shuijing=Shuijingzhu
Nanjing=Nankin
Shanghai=Szanghaj
Huaian=Huai’an
Laian=Lai’an
Yahe=Ayahuasca
Tianjin=Tiencin
Beijing=Pekin
Lviv=Lwów
Yavoriv=Jaworów
Ivano Frankivsk=Iwano-Frankiwsk
Chernivtsi=Czerniowce
Kolomyya=Kołomyja
Uzhhorod=Użhorod
Berehove=Berehowo
Khust=Chust
Oryavchyk=Orawczyk
Sambir=Sambor
Ternopil=Tarnopol
Pochaiv=Poczajów
Chervonohrad=Czerwonogród
Kovel=Kowel
Lutsk=Łuck
Rivne=Równe
Varash=Warasz
Stepan=Stepań
Kostopil=Kostopol
Lyuboml=Luboml
Kyiv=Kijów
Chernihiv=Czernihów
Ivankiv=Iwanków
Korosten=Korosteń
Zhytomyr=Żytomierz
Borodyanka=Borodzianka
Bila Tserkva=Biała Cerkiew
Fastiv=Fastów
Berdychiv=Berdyczów
Vinnytsia=Winnica
Kalynivka=Kałyniwka
Kryzhopil=Krzyżopol
Khmelnytskyi=Chmielnicki
Shepetivka=Szepetówka
Zviahel=Zwiahel
Chortkiv=Czortków
Khotyn=Chocim
Dunaivtsi=Dunajowce
Sharhorod=Szarogród
Uman=Humań
Cherkasy=Czerkasy
Kropyvnytskyi=Kropywnycki
Oleksandriya=Aleksandria
Smila=Smiła
Nadlak=Nădlac
Domanivka=Domaniwka
Rivne=Równe
Odesa=Odessa
Podilsk=Podolsk
Zakharivka=Zachariwka
Ladyzhyn=Ładyżyn
Mykolaiv=Mikołajów
Kherson=Chersoń
Nova Kakhovka=Nowa Kachowka
Kryvyi Rih=Krzywy Róg
Bashtanka=Basztanka
Zaporizhzhia=Zaporoże
Tomakivka=Tomakiwka
Dnipro=Dniepr
Berdyans'k=Berdiańsk
Donetsk=Donieck
Kerch=Kercz
Feodosia=Teodozja
Simferopol=Symferopol
Yalta=Jałta
Sevastopol=Sewastopol
Yevpatoriya=Eupatoria
Dzhankoi=Dżankoj
Ishun=Krasnoperekopsk
Bilmak=Kamjanka
Orikhiv=Orichiw
Heniches'k=Geniczesk
Mykolaiv=Mikołajów
Phuket=Prowincja Phuket
Lopburi=Lop Buri
Hashtpar=Hasztpar
Tabriz=Tebriz
Miandoab=Mijandoab
Khoy=Choj
Miandoab=Mijandoab
Baneh=Bane
Sanandaj=Sanandadż
Hamedan=Hamadan
Tehran=Teheran
Karaj=Karadż
Rasht=Raszt
Qazvin=Kazwin
Lahijan=Lahidżan
Behshahr=Behszahr
Qaem Shahr=Gha’emszahr
Saveh=Sawe
Qom=Kom
Kashan=Kaszan
Varamin=Waramin
Malayer=Malajer
Naeen=Na’in
Borujerd=Borudżerd
Khorramabad=Chorramabad
Kuhdasht=Kuhdaszt
Kermanshah=Kermanszah
Qorveh=Ghorwe
Khorramshahr=Chorramszahr
Ahvaz=Ahwaz
Gachsaran=Dogonbadan
Behbahan=Behbehan
Shiraz=Sziraz
Yasuj=Jasudż
Abadeh=Abade
Shahreza=Szahreza
Shushtar=Szusztar
Izeh=Ize
Shahrekord=Szahr-e Kord
Bushehr=Buszehr
Jahrom=Dżahrom
Bandar Abbas=Bandar-e Abbas
Chah Bahar=Czabahar
Mazatlan=Mazatlán
San Luis Potosi=San Luis Potosí
Lázaro Cárdenas=Lázaro Cárdenas del Río
Xalapa=Xalapa-Enríquez
Chilpancingo=Chilpancingo de los Bravo
Cumana=Cumaná
Holoby=Hołoby
Lanivtsi=Łanowce
Berezhany=Brzeżany
Waratah=Telopea
Saint Helens=St Helens
George Town=Georgetown
Gladstone=William Ewart Gladstone
Miles=Mila
Casino=Kasyno
St George=Jerzy
Emerald=Szmaragd
Prairie=Preria
Willows=Wierzba
Flying Fox=Rudawka
Carnarvon=Caernarvon
Meadow=Łąka
Cervantes=Miguel de Cervantes
Denmark=Dania
Southern Cross=Gwiazdozbiór Krzyża Południa
Karijini=Karijini National Park
Sandstone=Piaskowiec
Whangārei=Whangarei
Serres=Seres
Bopo=Karta przedpłacona
St Lucia=Saint Lucia
Gunza=Porto Amboim
Chio=Chios
Šibenik=Szybenik
Didima=Didyma
Astros=Houston Astros
Paphos=Pafos
Botevgrad=Botewgrad
Kiliya=Kilia
Olenivka=Ołeniwka
Yeysk=Jejsk
Tiberias=Tyberiada
Obama=Barack Obama
Gammas=Gamma
Rio Gallegos=Río Gallegos
Valdes=Valdéz
Río Colorado=Kolorado
Neuquen=Neuquén
Casa Blanca=Casablanca
Zarate=Zárate
Goya=Francisco Goya
Paraná=Parana
América=Stany Zjednoczone
Reconquista=Rekonkwista
Formosa=Geografia Tajwanu
Orán=Oran
Santa María=Santa Maria
La Para=La Pare
Artigas=José Gervasio Artigas
Tacuarembo=Tacuarembó
Florida=Floryda
Trinidad=Trynidad
Guichon=Guichón
Dorado=Złota Ryba
Jesuitas=Jesuítas
Puerto Suárez=Puerto Suarez
Palmito=Serce palmy
Concepcion=Concepción
Porvenir=El Porvenir
Bagua=Osiem trygramów
Málaga=Malaga
Cayenne=Kajenna
Aurora=Zorza polarna
El Salvador=Salwador
Paihuano=Paiguano
San Felipe=Saint Philip
Curico=Curicó
Los Ángeles=Los Angeles
Puerto Aysén=Puerto Aisén
Xèrica=Jérica
Forli=Forlì
Hlybokaye=Głębokie
Narač=Narocz
Stryi=Stryj
Rakhiv=Rachów
Vărșand=Pilu
Kozloduy=Kozłoduj
Sarnitsa=Syrnica
Smolyan=Smolan
Sevlievo=Sewliewo
Grevena=Grewena
Thermi=Termi
Shkodër=Szkodra
Tetovo=Tetowo
Radovish=Radowisz
Knjazevac=Knjaževac
Pancevo=Pančevo
Čačinci=Gmina Čačinci
Landau=Landau in der Pfalz
Schaffhausen=Szafuza
Éauze=Eauze
St Moritz=Sankt Moritz
Levoča=Lewocza
Aïn El Hadjel=Ajn al-Hadżal
Sidi Aissa=Sidi Isa
Aïn Touta=Ajn at-Tuta
Guelma=Kalima
Mohammedia=Al-Muhammadijja
El Jem=Al-Dżamm
Sidi Bouzid=Sidi Bu Zajd
Medinine=Madanin
Primavera=La Primavera
Uacari=Uakari
Caruru=Carurú
Santo Antônio=Santo António
Taboca=Czoktawowie
Entre Rios=Entre Ríos
Feijó=Diogo Antônio Feijó
Matisse=Henri Matisse
Tamanduá=Tamandua
Fuma=Kotarō Fūma
Primavera=La Primavera
Ribeirao Preto=Ribeirão Preto
Estância=Estancja
Jeju=Czedżu
Cobras=Kobry
Taboca=Czoktawowie
Vila Rica=Ouro Preto
Luciára=Luciara
Muting=Mute
Ofunato=Ōfunato
Aira=Śmiałka
Hashtrud=Hasztrud
Baiji=Baji chiński
Al Hasakah=Al-Hasaka
Saraqib=Sarakib
Al Furqlus=Al-Furklus
Shahba=Szahba
Rachaiya=Raszajja
Sde Boker=Sede Boker
Kerak=Al-Karak
Ashdod=Aszdod
Netanya=Netanja
Jenin=Dżanin
Jericho=Jerycho
Karameh=Al-Karama
Tamarindo=Tamaryndowiec indyjski
Roxana=Roksana
Usulutan=Usulután
El Paraiso=El Paraíso
Monterrico=Monterrrico
Jalapa=Xalapa-Enríquez
Chacmool=Chac Mool
Coba=Cobá
Maruata=Waverley
San Felipe=Saint Philip
Teziutlan=Teziutlán
Honey=Miód
Trinidad=Trynidad
Venus=Wenus
St. Augustine=Augustyn z Hippony
Savannah=Sawanna
Florence=Florencja
Athens=Ateny
Rome=Rzym
Perry=Gruszecznik
Florence=Florencja
Andalusia=Andaluzja
Troy=Troja
Panama City=Panama
New Orleans=Nowy Orlean
Kosciusko=Tadeusz Kościuszko
Warsaw=Warszawa
Berne=Berno
Radcliff=Radcliffe
Athens=Ateny
Alexandria=Aleksandria
Philadelphia=Filadelfia
New York=Nowy Jork
Bethel=Betel
Lebanon=Liban
Potsdam=Poczdam
Buffalo=Bawół
Farmville=FarmVille
Flint=Krzemień
Mt Pleasant=Mount Pleasant
Niagara Falls=Niagara
London=Londyn
Ironwood=Drzewo żelazne
Schaumburg=Powiat Schaumburg
Virginia=Wirginia
Sandstone=Piaskowiec
St Cloud=St. Cloud
Alexandria=Aleksandria
Hague=Haga
Century=Wiek
Oxford=Oksford
Tupelo=Błotnia
Corinth=Korynt
Vermillion=Cynober
Buffalo=Bawół
Faith=Wiara religijna
Wall=Mur
Alliance=Sojusz
Beaver=Bóbr
Perry=Gruszecznik
Choctaw=Czoktawowie
Washington=Waszyngton
Alexandria=Aleksandria
Hope=Nadzieja
Mt Ida=Ida
Mt Pleasant=Mount Pleasant
Atlantic=Ocean Atlantycki
Lebanon=Liban
Hayti=Haiti
Bolivar=Simón Bolívar
Metropolis=pl:Unia Metropolii Polskich
Cuba=Kuba
Grants=Grant
Belen=Belén
Trinidad=Trynidad
Boulder=Głaz
Rye=Żyto zwyczajne
Buffalo=Bawół
Cheyenne=Szejeni
Lake=Jezioro
Baker=Piekarz
Pray=Modlitwa
Circle=Okrąg
Jordan=Jordania
Coeur d'Alene=Coeur d’Alene
Moscow=Moskwa
Riddle=Szarada
Cobalt=Kobalt
Aragonite=Aragonit
Price=Cena
St. George=Jerzy
Republic=Republika
Forks=Widelec
Rome=Rzym
Sisters=Siostra
Florence=Florencja
Brothers=Brat
Plush=Plusz
Baker=Piekarz
Alamo=Bitwa o Alamo
Rachel=Rachela
Globe=Globus
St Johns=St. John’s
North Rim=Park Narodowy Wielkiego Kanionu
Nothing=Niebyt
Baker=Piekarz
Boron=Bor
Bishop=Biskup
Weed=Chwast
Peanut=Orzacha podziemna
Fort Bragg=Fort Liberty
Canadian=Kanadyjczycy
Canyon=Przełom rzeki
Spur=Ostroga
Turkey=Turcja
Eldorado=El Dorado
Temple=Świątynia
Comanche=Komancze
West=Zachód
Athens=Ateny
Paris=Paryż
El Rifle=Walter Pandiani
Bahía Tortugas=Kalifornia Dolna Południowa
San Felipe=Saint Philip
Moctezuma=Montezuma
San Nicolas=San Nicolás
Trail=Ścieżka
Princeton=Uniwersytet Princeton
Pavilion=Pawilon
Anzac=Australian and New Zealand Army Corps
Athabasca=Athabaska
Red Deer=Jeleń szlachetny
Orkney=Orkady
Hudson Bay=Zatoka Hudsona
Mallard=Krzyżówka
Manitou=Manitu
Utqiagvik=Utqiaġvik
Wales=Walia
Candle=Świeca
Bethel=Betel
Valdez=Valdéz
Chicken=Kura domowa
Longlac=Greenstone
Dryden=John Dryden
Flanders=Flandria
Québec City=Quebec
Cornwall=Kornwalia
St. John's=St. John’s
Southend=Southend-on-Sea
Canyon=Przełom rzeki
Tungsten=Wolfram
Bible=Biblia
Polaris=Alfa Ursae Minoris
Arthur's Town=Arthur’s Town
The Bluff=Bluff
Florida=Floryda
Balfour Town=Balfour
Lihue=Līhuʻe
Kailua Kona=Kailua
Sirjan=Sirdżan
Neyriz=Nejriz
Rafsanjan=Rafsandżan
Shahdad=Szahdad
Jiroft=Dżiroft
Birjand=Birdżand
Mashhad=Meszhed
Torbat e Jam=Torbat-e Dżam
Kashmar=Kaszmar
Ferdows=Ferdous
Sabzevar=Sabzewar
Bojnurd=Bodżnurd
Shirvan=Szyrwan
Quchan=Ghuczan
Khur=Kułan indyjski
Yazd=Jazd
Bafq=Bafgh
Turkmenbashi=Turkmenbaszy
Dashoguz=Daszoguz
Turkmenabat=Türkmenabat
Gowurdak=Magdanly
Yoloten=Ýolöten
Tejen=Tedżen
Ashgabat=Aszchabad
Zaranj=Zarandż
Spin Buldak=Spin Boldak
Lashkar Gah=Laszkargah
Marjah=Mardża
Khost=Chost
Jalalabad=Dżalalabad
Taleqan=Taleghan
Aybak=Ajbak
Mazar i Sharif=Mazar-i Szarif
Sheberghan=Szeberghan
Bamyan=Bamian
Yelizovo=Jelizowo
Ivashka=Ilja Iwaszka
Pevek=Pewek
Egvekinot=Egwiekinot
Omsukchan=Omsukczan
Okhotsk=Ochock
Nakhodka=Nachodka
Ussuriysk=Ussuryjsk
Arsenyev=Arsienjew
Dalnegorsk=Dalniegorsk
Lesozavodsk=Lesozawodzk
Luchegorsk=Łuczegorsk
Terney=Ternej
Khabarovsk=Chabarowsk
Vanino=Wanino
Bulava=R-30 Buława
Yuzhno Sakhalinsk=Jużnosachalińsk
Smirnykh=Smirnych
Nysh=Nysz
Magdagachi=Magdagaczi
Blagoveshchensk=Błagowieszczeńsk
Arkhara=Archara
Birobidzhan=Birobidżan
Borzya=Borzja
Chernyshevsk=Czernyszewsk
Mogocha=Mogocza
Urusha=Urusza
Irkutsk=Irkuck
Cheremkhovo=Czeremchowo
Ulan Ude=Ułan Ude
Ulyoty=Uloty
Novaya Chara=Nowaja Czara
Turt=Turț
Ulaanbaatar=Ułan Bator
Choir=Chór
Chinggis=Czyngis-chan
Khorgo=Chorgo
Tes=TES
Sainshand=Sajnszand
Turpan=Turfan
Ürümqi=Urumczi
Ejin Banner=Ejin Qi
Bayannur=Bayan Nur
Zalantun=Zhalantun
Hulunbuir=Hulun Buir
Da Hinggan Ling=Wielki Chingan
Holingol=Huolingol
Jarud Banner=Jarud Qi
Xilingol League=Xilin Gol
Kyzyl=Kyzył
Novokuznetsk=Nowokuźnieck
Barnaul=Barnauł
Novosibirsk=Nowosybirsk
Ordynskoye=Ordynskoje
Kulunda=Kułunda
Rubtsovsk=Rubcowsk
Belokurikha=Biełokuricha
Biysk=Bijsk
Artybash=Artybasz
Ongudai=Ongudaj
Hainan=Hajnan
Alxa League=Alxa
Deqen=Dêqên
Chamdo=Qamdo
Shigatse=Xigazê
Ngari Prefecture=Ngari
Gar=Niszczukokształtne
Bishkek=Biszkek
Almaty=Ałmaty
Balykchy=Bałykczy
Karakol=Karakoł
Osh=Osz
Jalal Abad=Dżalalabad
Talas=Tałas
Karakalpakia=Karakałpacja
Moynaq=Moʻynoq
Urgench=Urgencz
Turtkul=Toʻrtkoʻl
Zarafshan=Zarafshon
Uchkuduk=Uchquduq
Chimbay=Chimboy
Navoi=Nawoi
Bukhara=Buchara
Jizzakh=Dżyzak
Tashkent=Taszkent
Khujand=Chodżent
Dustlik=Doʻstlik
Qarshi=Karszy
Mubarek=Muborak
Denau=Denov
Oktyabr=Akciabr
Istaravshan=Istarawszan
Panjakent=Pandżakent
Dushanbe=Duszanbe
Qurgonteppa=Bochtar
Vakhsh=Wachsz
Kulob=Kulab
Gharm=Garm
Khorog=Chorog
Tokhtamysh=Tochtamysz
Bhimdatta=Mahendranagar
Nepalgunj=Nepalgańdź
Arvaikheer=Arwajcheer
Dalanzadgad=Dalandzadgad
Zharkent=Żarkent
Taldykorgan=Tałdykorgan
Konaev=Konajew
Tacheng Prefecture=Tacheng
Alar=Daminozyd
Talimu Pendi=Kotlina Kaszgarska
Kashgar=Kaszgar
Maralbexi=Bachu
Luobupo=Lob-nor
Sumqayit=Sumgait
Mingecevir=Mingeczaur
Shirvan=Szyrwan
Lankaran=Lenkoran
Beylagan=Rejon Beyləqan
Ismailli=İsmayıllı
Zangilan=Zəngilan
Nakhchivan=Nachiczewan
Jermuk=Dżermuk
Vardenis=Wardenis
Gyumri=Giumri
Stepanavan=Stepanawan
Yerevan=Erywań
Armavir=Armawir
Telavi=Telawi
Tskhinvali=Cchinwali
Borjomi=Bordżomi
Zestafoni=Zestaponi
Lanchkhuti=Lanczchuti
Sokhumi=Suchumi
Zhanaozen=Żangaözen
Beyneu=Bejneu
Kulsary=Kułsary
Shalkar=Szałkar
Kandyagash=Kandyagasz
Embi=Jemby
Ayteke Bi=Äjteke Bi
Kazaly=Kazały
Kazaly=Kazały
Kyzylorda=Kyzyłorda
Baikonur=Bajkonur
Zhanakorgan=Żangakorgan
Turkistan=Turkiestan
Shu=Szu
Merki=Merke
Shymkent=Szymkent
Zhetisay=Żetysaj
Priozersk=Prioziersk
Shakhtinsk=Szachtinsk
Shchuchinsk=Szczuczyńsk
Kokshetau=Kokczetaw
Petropavl=Pietropawłowsk
Ruzaevka=Ruzajewka
Kostanay=Kustanaj
Zhetikara=Żytykara
Arkalyk=Arkałyk
Zhezqazghan=Żezkazgan
Baykonur=Bajkonur
Betpak Dala=Betpakdała
Karazhal=Karażał
Bay=Zatoka
Ayagoz=Ajagöz
Urzhar=Ürżar
Semey=Semej
Charsk=Szar
Oskemen=Ust-Kamienogorsk
Pavlodar=Pawłodar
Ekibastuz=Jekybastuz
Karkaraly=Karkarały
Ereymentau=Jerejmentau
Makhachkala=Machaczkała
Izberbash=Izberbasz
Akhty=Achty
Khunzakh=Chunzach
Khasavyurt=Chasawiurt
Vladikavkaz=Władykaukaz
Nazran=Nazrań
Nalchik=Nalczyk
Pyatigorsk=Piatigorsk
Stavropol=Stawropol
Svetlograd=Swietłograd
Budyonnovsk=Budionnowsk
Neftekumsk=Nieftiekumsk
Kamyzyak=Kamyziak
Astrakhan=Astrachań
Rostov on Don=Rostów nad Donem
Bataysk=Batajsk
Zernograd=Ziernograd
Tikhoretsk=Tichorieck
Kropotkin=Piotr Kropotkin
Novorossiysk=Noworosyjsk
Gelendzhik=Gelendżyk
Poltavskaya=Połtawskaja
Sochi=Soczi
Maykop=Majkop
Labinsk=Łabinsk
Armavir=Armawir
Cherkessk=Czerkiesk
Volgograd=Wołgograd
Ilovlya=Iłowla
Surovikino=Surowikino
Kamyshin=Kamyszyn
Akhtubinsk=Achtubinsk
Kharabali=Charabali
Yashkul=Jaszkul
Volgodonsk=Wołgodońsk
Mirnyy=Mirny
Shostka=Szostka
Nizhyn=Niżyn
Pereiaslav=Perejasław
Hoholiv=Hoholiw
Pryluky=Pryłuki
Lubny=Łubnie
Zolotonosha=Złotonosza
Kremenchuk=Krzemieńczuk
Poltava=Połtawa
Myrhorod=Mirhorod
Okhtyrka=Ochtyrka
Kharkiv=Charków
Chuhuiv=Czuhujew
Izyum=Izium
Pavlohrad=Pawłohrad
Lozova=Łozowa
Luhansk=Ługańsk
Severodonetsk=Siewierodonieck
Markivka=Markiwka
Svatove=Swatowe
Shakhty=Szachty
Donetsk=Donieck
Morozovsk=Mrozowsk
Krasnoyarsk=Krasnojarsk
Achinsk=Aczyńsk
Hadyach=Hadziacz
Nikel=Nikiel
Murmansk=Murmańsk
Verkhnetulomsky=Wierchnietułomskij
Tumanny=Tumannyj
Sosnovka=Sasnouka
Apatity=Apatyty
Kovdor=Kowdor
Nadvoitsy=Nadwojcy
Pudozh=Pudoż
Povenets=Powieniec
Medvezhyegorsk=Miedwieżjegorsk
Petrozavodsk=Pietrozawodsk
Sortavala=Sortawała
Pitkyaranta=Pitkiaranta
Suoyarvi=Suojarwi
Repola=Rieboły
Kostomuksha=Kostomuksza
St Petersburg=Petersburg
Volkhov=Wołchow
Lodeynoye Pole=Łodiejnoje Pole
Shlisselburg=Szlisselburg
Vyborg=Wyborg
Priozersk=Prioziersk
Gatchina=Gatczyna
Kingisepp=Kingisiepp
Sosnovy Bor=Sosnowy Bór
Hakkas=Hakka
Samarkand=Samarkanda
Kirishi=Kiriszy
Veliky Novgorod=Nowogród Wielki
Staraya Russa=Stara Russa
Siversky=Siwierskij
Plyussa=Plussa
Pskov=Psków
Gdov=Gdow
Pechory=Pieczory
Opochka=Opoczka
Sebezh=Siebież
Velikiye Luki=Wielkie Łuki
Porkhov=Porchow
Klintsy=Klińce
Novozybkov=Nowozybkow
Bryansk=Briańsk
Roslavl=Rosław
Shumyachi=Szumiaczi
Smolensk=Smoleńsk
Moscow=Moskwa
Tver=Twer
Volokolamsk=Wołokołamsk
Rzhev=Rżew
Vyazma=Wiaźma
Velizh=Wieliż
Sergiyev Posad=Siergijew Posad
Pokrov=Pokrow
Lakinsk=Łakinsk
Yaroslavl=Jarosław
Ivanovo=Iwanowo
Kovrov=Kowrow
Vichuga=Wiczuga
Rostov=Rostów nad Donem
Vologda=Wołogda
Gryazovets=Griazowiec
Rybinsk=Rybińsk
Poshekhonye=Poszechonje
Cherepovets=Czerepowiec
Ustyuzhna=Ustiużna
Vesyegonsk=Wiesiegonsk
Uglich=Uglicz
Kalyazin=Kalazin
Bezhetsk=Bieżeck
Vytegra=Wytiegra
Tikhvin=Tichwin
Novouzensk=Nowouziensk
Saratov=Saratów
Syzran=Syzrań
Khvalynsk=Chwałyńsk
Chapayevsk=Czapajewsk
Sorochinsk=Soroczynsk
Kumertau=Kumiertau
Tuymazy=Tujmazy
Oktyabrsky=Oktiabr´skij
Ulyanovsk=Uljanowsk
Dimitrovgrad=Dimitrowgrad
Nizhnekamsk=Niżniekamsk
Naberezhnye Chelny=Nabierieżnyje Czełny
Neftekamsk=Nieftiekamsk
Chaykovsky=Czajkowski
Kizel=Kizieł
Nizhny Tagil=Niżny Tagił
Izhevsk=Iżewsk
Glazov=Głazow
Sarapul=Sarapuł
Mozhga=Możga
Kazan=Kazań
Yoshkar Ola=Joszkar-Oła
Yaransk=Jaransk
Cheboksary=Czeboksary
Kanash=Kanasz
Nizhny Novgorod=Niżny Nowogród
Kuvandyk=Kuwandyk
Saraktash=Saraktasz
Sibay=Sibaj
Kartaly=Kartały
Troitsk=Troick
Chelyabinsk=Czelabińsk
Zlatoust=Złatoust
Asha=Ardibeheszt
Beloretsk=Biełorieck
Yekaterinburg=Jekaterynburg
Polevskoy=Polewskoj
Kolosovka=Kołosowka
Ishim=Iszym
Tyumen=Tiumeń
Yalutorovsk=Jałutorowsk
Kurgan=Kurhan
Shadrinsk=Szadrinsk
Gorodets=Gorodiec
Mariehamn=Maarianhamina
Omolon=Omołon
Srednekolymsk=Sriedniekołymsk
Chokurdakh=Czokurdach
Kadykchan=Kadykczan
Yukagir=Jukagir
Nizhneyansk=Niżniejansk
Verkhoyansk=Wierchojańsk
Batagay=Batagaj
Khandyga=Chandyga
Kyubeme=Kiubiemie
Aim=AIM
Aldan=Ałdan
Chulman=Czulman
Chagda=Czagda
Yakutsk=Jakuck
Churapcha=Czurapcza
Vorontsovo=Woroncowo
Norilsk=Norylsk
Gorodok=Haradok
Loknya=Łoknia
Toropets=Toropiec
Andreapol=Andrieapol
Torzhok=Torżok
Ostashkov=Ostaszków
Valday=Wałdaj
Proletariy=Proletarij
Borovichi=Borowicze
Nebolchi=Niebołczi
Udomlya=Udomla
Kotlovan=Wykop
Kaluga=Kaługa
Zhizdra=Żyzdra
Lyudinovo=Ludinowo
Medyn=Miedyń
Serpukhov=Sierpuchow
Novomoskovsk=Nowomoskowsk
Ryazan=Riazań
Kolomna=Kołomna
Nizhny Lomov=Niżni Łomow
Ruzayevka=Ruzajewka
Saransk=Sarańsk
Shilovo=Szyłowo
Oryol=Orzeł
Mtsensk=Mcensk
Plavsk=Pławsk
Voronezh=Woroneż
Yelets=Jelec
Livny=Liwny
Stary Oskol=Stary Oskoł
Trubchevsk=Trubczewsk
Belgorod=Biełgorod
Korocha=Korocza
Boguchar=Boguczar
Buturlinovka=Buturlinowka
Mikhaylovka=Michajłowka
Uryupinsk=Uriupinsk
Veshenskaya=Wioszenskaja
Bokovskaya=Bokowskaja
Kletskaya=Kletskaja
Lipetsk=Lipieck
Gryazi=Griazi
Michurinsk=Miczuryńsk
Lebedyan=Lebiediań
Tambov=Tambow
Morshansk=Morszansk
Kirsanov=Kirsanow
Serdobsk=Sierdobsk
Kuznetsk=Kuźnieck
Lopatino=Łapacina
Barysh=Barysz
Alatyr=Ałatyr
Sergach=Siergacz
Lukoyanov=Łukojanow
Vyksa=Wyksa
Kasimov=Kasimow
Arkhangelsk=Archangielsk
Kotlas=Kotłas
Sharya=Szaria
Chukhloma=Czuchłoma
Velsk=Wielsk
Kadnikov=Kadnikow
Belozersk=Biełoziersk
Vozhega=Wożega
Nyandoma=Niandoma
Zvenigovo=Zwienigowo
Sernur=Siernur
Orichi=Oriczi
Kirov=Kirow
Shakhunya=Szachunja
Orlov=Orłow
Obyachevo=Objaczewo
Syktyvkar=Syktywkar
Yaksha=Jakszowie
Berezniki=Bieriezniki
Yarensk=Jareńsk
Pechora=Peczora
Yamburg=Kingisiepp
Novy Urengoy=Nowy Urengoj
Kuybyshev=Kujbyszew
Kemerovo=Kemerowo
Bogotol=Bogotoł
Palochka=Ӏ
Vorkuta=Workuta
Karatayka=Karatajka
Salekhard=Salechard
Kharp=Charp
Nyagan=Niagań
Zarechnyy=Zariecznyj
Khanty Mansiysk=Chanty-Mansyjsk
Nefteyugansk=Nieftiejugansk
Demyanka=Diemjanka
Tavda=Tawda
Serov=Sierow
Sovetsky=Sowietskij
Noyabrsk=Nojabr´sk
Lyantor=Lantor
Tevriz=Tiewriz
Volochanka=Wołoczanka
Saskylakh=Saskyłach
Ebelyakh=Ebeljach
Vorontsovka=Taszir
Mutina=Modena
Kirensk=Kireńsk
Bratsk=Brack
Sayansk=Sajansk
Kuitun=Kuytun
Kodinsk=Kodyńsk
Kansk=Kańsk
Zelenogorsk=Zielenogorsk
Tayshet=Tajszet
Turukhansk=Turuchansk
Noginsk=Nogińsk
Eyik=Eijik
Zhigansk=Żygańsk
Olekminsk=Olokminsk
Yuktali=Juktali
Iyengra=Ijengra
Borogontsy=Borogoncy
Yegoryevsk=Jegorjewsk
Desnogorsk=Diesnogorsk
Kautokeino=Guovdageaidnu Kautokeino
Almetyevsk=Almietjewsk
Neftegorsk=Nieftiegorsk
Pugachyov=Pugaczow
Shetpe=Szetpe
Lisakovsk=Lisakowsk
Yashalta=Jaszałta
Buynaksk=Bujnaksk
Gebele=Qəbələ
Ijevan=Iczewan
Saint Paul=Paweł z Tarsu
Boueni=Bouéni
Malé=Male
Christmas Island=Wyspa Bożego Narodzenia
Los Llanos=Llanos
Ain Temouchent=Ajn Tumuszanat
Az Zāwiyah=Az-Zawija
Akhalkalaki=Achalkalaki
Tsalka=Calka
Novoazovsk=Nowoazowsk
Blahodatne=Błahodatne
Severo Kurilsk=Siewiero-Kurilsk
Kunashir=Kunaszyr
St Matthew Island=Wyspa Świętego Mateusza
Amchitka=Amczitka
Makassar=Makasar
Helen Reef=Hatohobei
Tendoo=Tendō
Nouméa=Numea
Lenakel=Lénakel
Micronesia=Mikronezja
Wales=Walia
Heard Island and McDonald Islands=Wyspy Heard i McDonalda
Gasherbrum=Gaszerbrum
El Qantara El Sharqiya=Al-Kantara
Dahshur=Dahszur
Zarqa=Az-Zarka
Tzofar=Cofar
Tafilah=At-Tafila
Al-Ruhaybah=Ar-Ruhajba
Amphipolis=Amfipolis
Drama=Dramat
Giannitsa=Janitsa
Příbram=Przybram
Naxos=Naksos
Baniyas=Banijas
Kiryat Shmona=Kirjat Szemona
Samothrace=Samotraka
Tel Aviv=Tel Awiw-Jafa
Ajloun=Adżlun
Qatraneh=Al-Katrana
Al-Dumayr=Ad-Dumajr
Shcholkine=Szczołkine
Apsheronsk=Apszerońsk
Yuzhne=Jużne